ReferenceContrat;numcompteur;Ancienindex;Nouvelindex;consommation;datereleve;periode;nombrejours;categorie
11001012;170809-0383;5841;6026;185;25/02/2021;202104;60;DOM
11001020;82450485;66;67;1;25/02/2021;202104;60;DOM
11001023;37219570191;24;71;47;25/02/2021;202104;60;DOM
11003001;37219571157;42;70;28;25/02/2021;202104;60;DOM
11003003;37219571165;88;125;37;25/02/2021;202104;60;DOM
11003004;37219571082;71;110;39;25/02/2021;202104;60;DOM
11003005;37219570928;105;143;38;25/02/2021;202104;60;DOM
11003006;37219571124;592;881;289;25/02/2021;202104;60;DOM
11003007;37219571231;42;65;23;25/02/2021;202104;60;DOM
11003008;37219570969;16;26;10;25/02/2021;202104;60;DOM
11112003;82450515;1602;1787;185;25/02/2021;202104;60;DOM
11112018;82450259;63;86;23;25/02/2021;202104;60;DOM
11112019;82369532;1396;1486;90;25/02/2021;202104;60;DOM
11112020;2016-07098723;1380;1552;172;25/02/2021;202104;60;DOM
11112021;37219570811;11;44;33;25/02/2021;202104;60;DOM
11112022;82368808;1524;1859;335;25/02/2021;202104;60;DOM
11112023;82449119;153;197;44;25/02/2021;202104;60;DOM
11112024;82450156;1575;1948;373;25/02/2021;202104;60;DOM
11112025;82450676;131;159;28;25/02/2021;202104;60;DOM
11112026;82449195;1510;1755;245;25/02/2021;202104;60;DOM
11112027;14250517712;1223;1437;214;25/02/2021;202104;60;DOM
11112028;82448993;637;776;139;25/02/2021;202104;60;DOM
11112029;82450268;41;52;11;25/02/2021;202104;60;DOM
11112030;82449477;1500;1719;219;25/02/2021;202104;60;DOM
11112031;82449183;2014;2422;408;25/02/2021;202104;60;DOM
11112032;37219578558;38;57;19;25/02/2021;202104;60;DOM
11112033;11112033-int;24;240;216;25/02/2021;202104;60;DOM
11112034;37219578426;334;557;223;25/02/2021;202104;60;DOM
11112035;37219571587;266;414;148;25/02/2021;202104;60;DOM
11112036;37219571777;49;68;19;25/02/2021;202104;60;DOM
11112037;37219569854;410;671;261;25/02/2021;202104;60;DOM
11112039;37219578434;25;40;15;25/02/2021;202104;60;DOM
11112040;37219571678;35;47;12;25/02/2021;202104;60;DOM
11112041;37219578442;59;208;149;25/02/2021;202104;60;DOM
11112042;37219573369;0;117;117;25/02/2021;202104;60;DOM
11112043;37219578368;28;41;13;25/02/2021;202104;60;DOM
11112045;37219578418;21;46;25;25/02/2021;202104;60;DOM
11117004;37219570902;93;111;18;25/02/2021;202104;60;DOM
11117011;1708090232;2088;2285;197;25/02/2021;202104;60;DOM
11117012;82449282;526;577;51;25/02/2021;202104;60;DOM
11117013;1708090052;1441;1494;53;25/02/2021;202104;60;DOM
11117014;1708090053;416;463;47;25/02/2021;202104;60;DOM
11117015;1708090054;584;597;13;25/02/2021;202104;60;DOM
11117016;1708090231;812;852;40;25/02/2021;202104;60;DOM
11117017;1708090255;889;914;25;25/02/2021;202104;60;DOM
11117018;11117018-int;2008;2026;18;25/02/2021;202104;60;DOM
11117019;11117019-int;427;518;91;25/02/2021;202104;60;DOM
11117039;82369408;208;230;22;25/02/2021;202104;60;DOM
11117049;41236931;17224;19533;2309;25/02/2021;202104;60;PROD
11117050;14225393736;10359;10700;341;25/02/2021;202104;60;PROD
11117051;1708090041;3311;3485;174;25/02/2021;202104;60;DOM
11117052;1708090302;1018;1172;154;25/02/2021;202104;60;DOM
11117053;11117053-int;3719;3799;80;25/02/2021;202104;60;DOM
11117054;1708090234;5159;5380;221;25/02/2021;202104;60;DOM
11117055;141826390;2913;3209;296;25/02/2021;202104;60;DOM
11117056;82369669;3735;4068;333;25/02/2021;202104;60;DOM
11117057;82368769;1218;1299;81;25/02/2021;202104;60;PROD
11117058;82368402;1341;1502;161;25/02/2021;202104;60;DOM
11117059;82369553;2051;2314;263;25/02/2021;202104;60;DOM
11117060;82368742;1381;1571;190;25/02/2021;202104;60;DOM
11117061;82369650;267;303;36;25/02/2021;202104;60;DOM
11117062;82369519;753;830;77;25/02/2021;202104;60;DOM
11117063;82449251;76;88;12;25/02/2021;202104;60;DOM
11117064;82449316;200;243;43;25/02/2021;202104;60;DOM
11117065;82369261;310;322;12;25/02/2021;202104;60;DOM
11117066;82453405;1299;1538;239;25/02/2021;202104;60;DOM
11117067;82449345;695;759;64;25/02/2021;202104;60;DOM
11117068;82449271;380;451;71;25/02/2021;202104;60;DOM
11117069;82450487;201;232;31;25/02/2021;202104;60;DOM
11117070;82450677;575;722;147;25/02/2021;202104;60;DOM
11117071;37219569847;25;47;22;25/02/2021;202104;60;DOM
11117072;37219578476;88;121;33;25/02/2021;202104;60;DOM
11117073;37219571454;11;15;4;25/02/2021;202104;60;DOM
11117074;82450263;137;174;37;25/02/2021;202104;60;PROD
11117075;37219569946;731;890;159;25/02/2021;202104;60;DOM
11117076;37219568492;44;90;46;25/02/2021;202104;60;DOM
11117077;82450493;6128;6315;187;25/02/2021;202104;60;DOM
11117078;37219570225;120;201;81;25/02/2021;202104;60;DOM
11117079;37219571025;63;81;18;25/02/2021;202104;60;DOM
11117080;37219571496;76;127;51;25/02/2021;202104;60;DOM
11117081;37219570910;31;38;7;25/02/2021;202104;60;DOM
11117082;11117082-int;565;649;84;25/02/2021;202104;60;PROD
11117083;341290392;814;1225;411;25/02/2021;202104;60;PROD
11119012;1703060001;2942;3149;207;25/02/2021;202104;60;DOM
11119025;1704040002;4334;4561;227;25/02/2021;202104;60;DOM
11119026;1704040003;608;646;38;25/02/2021;202104;60;DOM
11119041;41289747;1324;1324;0;25/02/2021;202104;60;PROD
11119042;82453036;100;117;17;25/02/2021;202104;60;DOM
11119043;82453334;561;666;105;25/02/2021;202104;60;DOM
11119044;82453002;60;66;6;25/02/2021;202104;60;DOM
11119045;82453245;358;651;293;25/02/2021;202104;60;DOM
11119046;1604215698;60;82;22;25/02/2021;202104;60;DOM
11119047;82449779;2674;2997;323;25/02/2021;202104;60;DOM
11119048;37219573260;0;63;63;25/02/2021;202104;60;DOM
11120003;82450322;179;209;30;25/02/2021;202104;60;DOM
11123012;11123012-int;1380;1637;257;25/02/2021;202104;60;DOM
11123014;37219578400;0;27;27;25/02/2021;202104;60;DOM
11124001;41236458;51260;56911;5651;25/02/2021;202104;60;PROD
11124015;1604213788;388;402;14;25/02/2021;202104;60;DOM
11124032;1708090204;2701;2893;192;25/02/2021;202104;60;DOM
11124033;1708090202;1831;1969;138;25/02/2021;202104;60;DOM
11124034;1708090132;5339;5513;174;25/02/2021;202104;60;DOM
11124035;11124035-int;3855;3945;90;25/02/2021;202104;60;DOM
11124036;1708090390;2541;2652;111;25/02/2021;202104;60;DOM
11124037;1708090228;947;1009;62;25/02/2021;202104;60;DOM
11124038;1708090131;1026;1092;66;25/02/2021;202104;60;DOM
11124039;11124039-int;5756;5823;67;25/02/2021;202104;60;DOM
11124040;11124040-int;3463;3531;68;25/02/2021;202104;60;DOM
11124041;11124041-int;5188;5407;219;25/02/2021;202104;60;DOM
11124042;1708090389;854;865;11;25/02/2021;202104;60;DOM
11124044;1708090134;16233;17271;1038;25/02/2021;202104;60;DOM
11124045;1708090206;4234;4275;41;25/02/2021;202104;60;DOM
11124048;11124048-int;921;949;28;25/02/2021;202104;60;DOM
11124049;11124049-int;6640;7045;405;25/02/2021;202104;60;DOM
11124051;14250493781;3845;3913;68;25/02/2021;202104;60;DOM
11124052;14-2253-9377-7;13538;14558;1020;25/02/2021;202104;60;PROD
11124054;1425493716;375;386;11;25/02/2021;202104;60;DOM
11124057;11124057-int;3404;3417;13;25/02/2021;202104;60;DOM
11124058;11124058-int;2420;2654;234;25/02/2021;202104;60;DOM
11124059;170800242;4800;5043;243;25/02/2021;202104;60;DOM
11124064;14250493757;2790;3234;444;25/02/2021;202104;60;DOM
11124065;2,02E+11;56;64;8;25/02/2021;202104;60;DOM
11124066;1604214301;2858;2992;134;25/02/2021;202104;60;DOM
11124067;14250493765;3035;3100;65;25/02/2021;202104;60;DOM
11124068;14250493724;2612;2705;93;25/02/2021;202104;60;DOM
11124069;11124069-int;1986;1986;0;25/02/2021;202104;60;DOM
11124070;1604215217;460;501;41;25/02/2021;202104;60;DOM
11124078;14250493773;3239;3448;209;25/02/2021;202104;60;DOM
11124080;2,02E+11;3315;3467;152;25/02/2021;202104;60;DOM
11124091;141826411;500;607;107;25/02/2021;202104;60;DOM
11124095;1604213240;7187;7693;506;25/02/2021;202104;60;DOM
11124096;14250493732;3780;3913;133;25/02/2021;202104;60;DOM
11124097;141826406;4451;4627;176;25/02/2021;202104;60;DOM
11124098;11124098-int;0;1092;1092;25/02/2021;202104;60;DOM
11124099;14250493740;588;621;33;25/02/2021;202104;60;DOM
11124100;1604215190;3252;3515;263;25/02/2021;202104;60;DOM
11124101;1604214803;6925;7127;202;25/02/2021;202104;60;DOM
11124102;1604215773;280;292;12;25/02/2021;202104;60;DOM
11124103;141826416;985;2107;1122;25/02/2021;202104;60;DOM
11124104;1604215218;2083;2107;24;25/02/2021;202104;60;DOM
11124105;1604214804;4705;4951;246;25/02/2021;202104;60;DOM
11124106;14250515203;2566;2608;42;25/02/2021;202104;60;DOM
11124107;170507141;1893;2037;144;25/02/2021;202104;60;DOM
11124108;14225394379;1955;2664;709;25/02/2021;202104;60;PROD
11124109;170505239;2952;2979;27;25/02/2021;202104;60;DOM
11124110;141826409;308;340;32;25/02/2021;202104;60;DOM
11124111;141826461;1537;1693;156;25/02/2021;202104;60;DOM
11124112;141826410;509;540;31;25/02/2021;202104;60;DOM
11124113;141826417;998;1115;117;25/02/2021;202104;60;DOM
11124114;141826464;3755;3755;0;25/02/2021;202104;60;DOM
11124115;2,02E+11;1188;1337;149;25/02/2021;202104;60;DOM
11124116;2,02E+11;575;589;14;25/02/2021;202104;60;DOM
11124117;41285545;6673;7615;942;25/02/2021;202104;60;PROD
11124118;2,02E+11;4026;4066;40;25/02/2021;202104;60;DOM
11124119;2,02E+11;366;392;26;25/02/2021;202104;60;DOM
11124120;1604214775;1456;1522;66;25/02/2021;202104;60;DOM
11124121;2,02E+11;5017;5180;163;25/02/2021;202104;60;DOM
11124122;2,02E+11;300;304;4;25/02/2021;202104;60;DOM
11124123;82368446;1386;1626;240;25/02/2021;202104;60;DOM
11124124;11124124-int;264;298;34;25/02/2021;202104;60;DOM
11124125;82368824;246;254;8;25/02/2021;202104;60;DOM
11124126;82368356;1463;1675;212;25/02/2021;202104;60;DOM
11124127;82368719;1652;1847;195;25/02/2021;202104;60;DOM
11124128;82367979;2559;2755;196;25/02/2021;202104;60;DOM
11124129;82448717;1777;1897;120;25/02/2021;202104;60;DOM
11124130;82368292;3059;3237;178;25/02/2021;202104;60;DOM
11124131;82368351;2201;2458;257;25/02/2021;202104;60;DOM
11124132;82368451;235;246;11;25/02/2021;202104;60;DOM
11124134;82368186;310;397;87;25/02/2021;202104;60;DOM
11124135;82369623;2547;2755;208;25/02/2021;202104;60;DOM
11124136;82368958;669;683;14;25/02/2021;202104;60;DOM
11124137;82369460;132;143;11;25/02/2021;202104;60;DOM
11124138;82369636;230;239;9;25/02/2021;202104;60;DOM
11124139;82368327;2079;2273;194;25/02/2021;202104;60;DOM
11124140;82369538;1347;1416;69;25/02/2021;202104;60;DOM
11124141;82368381;257;281;24;25/02/2021;202104;60;DOM
11124142;82368464;565;588;23;25/02/2021;202104;60;DOM
11124143;82369035;119;128;9;25/02/2021;202104;60;DOM
11124144;82367856;2302;2477;175;25/02/2021;202104;60;DOM
11124145;82368445;2390;2591;201;25/02/2021;202104;60;DOM
11124146;82368922;156;195;39;25/02/2021;202104;60;DOM
11124147;82368880;838;868;30;25/02/2021;202104;60;DOM
11124148;82450168;34;38;4;25/02/2021;202104;60;DOM
11124149;82450229;1202;1445;243;25/02/2021;202104;60;DOM
11124150;82368299;4712;4904;192;25/02/2021;202104;60;DOM
11124151;82368774;67;75;8;25/02/2021;202104;60;DOM
11124152;82368173;64;68;4;25/02/2021;202104;60;DOM
11124153;82368315;1426;1505;79;25/02/2021;202104;60;DOM
11124155;82368341;1234;1486;252;25/02/2021;202104;60;DOM
11124156;82368396;2087;2230;143;25/02/2021;202104;60;DOM
11124157;82368307;146;157;11;25/02/2021;202104;60;DOM
11124158;82368389;225;246;21;25/02/2021;202104;60;DOM
11124159;82368430;1237;1253;16;25/02/2021;202104;60;DOM
11124160;11124160-int;376;398;22;25/02/2021;202104;60;DOM
11124161;82368288;145;161;16;25/02/2021;202104;60;DOM
11124162;82368803;970;1049;79;25/02/2021;202104;60;DOM
11124163;82369622;279;309;30;25/02/2021;202104;60;DOM
11124164;82368279;743;785;42;25/02/2021;202104;60;DOM
11124165;82368320;298;316;18;25/02/2021;202104;60;DOM
11124167;82368441;184;221;37;25/02/2021;202104;60;DOM
11124168;82367824;1288;1529;241;25/02/2021;202104;60;DOM
11124169;82449018;1444;1631;187;25/02/2021;202104;60;DOM
11124170;82368347;3512;3822;310;25/02/2021;202104;60;DOM
11124171;82368848;338;376;38;25/02/2021;202104;60;DOM
11124172;82368985;1850;1855;5;25/02/2021;202104;60;DOM
11124173;82369656;628;640;12;25/02/2021;202104;60;DOM
11124174;37219573237;0;50;50;25/02/2021;202104;60;DOM
11124175;2016-07099241;2;4;2;25/02/2021;202104;60;DOM
11124176;82368117;639;648;9;25/02/2021;202104;60;DOM
11124177;37219571074;177;216;39;25/02/2021;202104;60;DOM
11124178;82369869;145;192;47;25/02/2021;202104;60;DOM
11124179;82369405;1363;1500;137;25/02/2021;202104;60;DOM
11124180;82453049;1348;1539;191;25/02/2021;202104;60;DOM
11124181;82369492;115;134;19;25/02/2021;202104;60;DOM
11124182;82449313;760;781;21;25/02/2021;202104;60;DOM
11124183;82368899;187;204;17;25/02/2021;202104;60;DOM
11124184;82450486;29;33;4;25/02/2021;202104;60;DOM
11124185;82369888;1196;1393;197;25/02/2021;202104;60;DOM
11124186;37219571306;31;37;6;25/02/2021;202104;60;DOM
11124187;1704040001;367;538;171;25/02/2021;202104;60;DOM
11124188;82449378;100;250;150;25/02/2021;202104;60;DOM
11124189;82369124;189;232;43;25/02/2021;202104;60;DOM
11124190;37219569078;0;50;50;25/02/2021;202104;60;DOM
11124191;82369200;771;890;119;25/02/2021;202104;60;DOM
11124192;82369475;76;84;8;25/02/2021;202104;60;DOM
11124193;2018-01131038;1162;1167;5;25/02/2021;202104;60;DOM
11124194;82450262;714;721;7;25/02/2021;202104;60;DOM
11124195;82368091;285;318;33;25/02/2021;202104;60;DOM
11124196;82368696;1264;1359;95;25/02/2021;202104;60;DOM
11124197;82369116;661;789;128;25/02/2021;202104;60;DOM
11124199;82369918;1461;1623;162;25/02/2021;202104;60;DOM
11124200;82369657;72;79;7;25/02/2021;202104;60;DOM
11124201;82450662;152;168;16;25/02/2021;202104;60;DOM
11124202;82450520;3;3;0;25/02/2021;202104;60;DOM
11124203;11124203-int;509;509;0;25/02/2021;202104;60;DOM
11124204;82450140;765;936;171;25/02/2021;202104;60;DOM
11124205;82449762;943;1079;136;25/02/2021;202104;60;DOM
11124206;37219578343;63;89;26;25/02/2021;202104;60;DOM
11124207;82450066;282;310;28;25/02/2021;202104;60;DOM
11124208;82450221;196;222;26;25/02/2021;202104;60;DOM
11124209;31219571322;210;242;32;25/02/2021;202104;60;DOM
11124210;11124210-int;105;129;24;25/02/2021;202104;60;DOM
11124211;82449290;1044;1199;155;25/02/2021;202104;60;DOM
11124213;37219571553;2116;2432;316;25/02/2021;202104;60;DOM
11124214;41235933;11523;12795;1272;25/02/2021;202104;60;PROD
11124215;82450595;84;91;7;25/02/2021;202104;60;DOM
11124216;82449291;258;281;23;25/02/2021;202104;60;DOM
11124217;82450504;1005;1176;171;25/02/2021;202104;60;DOM
11124218;37219578723;63;63;0;25/02/2021;202104;60;DOM
11124220;82450318;80;98;18;25/02/2021;202104;60;DOM
11124221;82449381;1514;1574;60;25/02/2021;202104;60;DOM
11124222;82448799;2113;2451;338;25/02/2021;202104;60;DOM
11124223;82450426;25;31;6;25/02/2021;202104;60;DOM
11124224;82451684;780;885;105;25/02/2021;202104;60;DOM
11124225;37219570936;88;113;25;25/02/2021;202104;60;DOM
11124226;82449129;1097;1187;90;25/02/2021;202104;60;DOM
11124228;82450264;1173;1197;24;25/02/2021;202104;60;DOM
11124229;41290123;3666;4077;411;25/02/2021;202104;60;PROD
11124230;41298968;7174;7977;803;25/02/2021;202104;60;PROD
11124231;82450654;1588;2057;469;25/02/2021;202104;60;DOM
11124232;37219571470;1294;1520;226;25/02/2021;202104;60;DOM
11124233;11124233-int;190;215;25;25/02/2021;202104;60;DOM
11124234;82449432;1352;1692;340;25/02/2021;202104;60;DOM
11124235;11124235;417;506;89;25/02/2021;202104;60;DOM
11124236;82449885;29;38;9;25/02/2021;202104;60;DOM
11124237;82450256;444;491;47;25/02/2021;202104;60;DOM
11124238;82449961;39;46;7;25/02/2021;202104;60;DOM
11124239;11124239-int;125;151;26;25/02/2021;202104;60;DOM
11124240;82450052;199;215;16;25/02/2021;202104;60;DOM
11124241;82451027;2249;2603;354;25/02/2021;202104;60;DOM
11124242;11124242-int;161;202;41;25/02/2021;202104;60;PROD
11124243;41289665;1659;1800;141;25/02/2021;202104;60;PROD
11124244;11124244-int;120;143;23;25/02/2021;202104;60;DOM
11124245;37219572536;810;940;130;25/02/2021;202104;60;DOM
11124246;82449159;10665;11932;1267;25/02/2021;202104;60;DOM
11124247;11124247-int;125;151;26;25/02/2021;202104;60;DOM
11124248;37219578830;10;14;4;25/02/2021;202104;60;DOM
11124249;82450226;576;654;78;25/02/2021;202104;60;DOM
11124250;82449694;130;169;39;25/02/2021;202104;60;DOM
11124251;37219573302;0;565;565;25/02/2021;202104;60;PROD
11124252;37219569813;109;123;14;25/02/2021;202104;60;DOM
11124253;82450112;62;73;11;25/02/2021;202104;60;DOM
11124254;37219577477;33;46;13;25/02/2021;202104;60;DOM
11124256;37219568153;27;47;20;25/02/2021;202104;60;DOM
11124257;11124257-int;441;458;17;25/02/2021;202104;60;PROD
11124258;37219578707;1;19;18;25/02/2021;202104;60;DOM
11124259;11124259-int;92;251;159;25/02/2021;202104;60;DOM
11124260;37219571421;70;83;13;25/02/2021;202104;60;DOM
11124261;37219571058;1929;2245;316;25/02/2021;202104;60;DOM
11124262;37219572205;233;296;63;25/02/2021;202104;60;DOM
11124263;37219572213;94;138;44;25/02/2021;202104;60;DOM
11124264;37219572288;239;277;38;25/02/2021;202104;60;DOM
11124266;82448572;61;74;13;25/02/2021;202104;60;DOM
11124271;37219577469;17;22;5;25/02/2021;202104;60;DOM
11124272;37219577485;73;168;95;25/02/2021;202104;60;DOM
11124273;37219577261;13;16;3;25/02/2021;202104;60;DOM
11124274;37219577139;24;33;9;25/02/2021;202104;60;DOM
11124275;37219577444;61;79;18;25/02/2021;202104;60;DOM
11124276;37219577501;471;646;175;25/02/2021;202104;60;DOM
11124277;37219578244;189;388;199;25/02/2021;202104;60;DOM
11124278;37219570761;0;317;317;25/02/2021;202104;60;DOM
11124279;37219578384;0;60;60;25/02/2021;202104;60;DOM
11124280;37219577113;187;234;47;25/02/2021;202104;60;DOM
11124281;37219577295;41;57;16;25/02/2021;202104;60;DOM
11124282;37219577394;165;227;62;25/02/2021;202104;60;DOM
11124283;37219573344;0;543;543;25/02/2021;202104;60;DOM
11124286;37219578350;0;46;46;25/02/2021;202104;60;PROD
11124290;37219578392;0;38;38;25/02/2021;202104;60;DOM
11124295;37219573237;0;103;103;25/02/2021;202104;60;PROD
11124296;11124296;0;121;121;25/02/2021;202104;60;PROD
11124297;37219573294;0;588;588;25/02/2021;202104;60;PROD
11124298;11124298;0;208;208;25/02/2021;202104;60;PROD
11201001;82450583;651;796;145;25/02/2021;202104;60;DOM
11201002;82368404;332;387;55;25/02/2021;202104;60;DOM
11201003;37219571769;66;109;43;25/02/2021;202104;60;DOM
11201008;37219578806;36;62;26;25/02/2021;202104;60;DOM
11201021;82368478;2019;2322;303;25/02/2021;202104;60;DOM
11201022;1708090300;2311;2518;207;25/02/2021;202104;60;DOM
11201033;82368371;3741;3883;142;25/02/2021;202104;60;DOM
11201034;82369714;42;46;4;25/02/2021;202104;60;DOM
11201037;37219578293;18;32;14;25/02/2021;202104;60;DOM
11201038;82449707;410;777;367;25/02/2021;202104;60;DOM
11201039;37219570407;635;958;323;25/02/2021;202104;60;DOM
11220001;1708080292;2293;2294;1;25/02/2021;202104;60;DOM
11220025;1703060035;4543;4946;403;25/02/2021;202104;60;DOM
11220026;1708090292;8421;9120;699;25/02/2021;202104;60;DOM
11220028;1604215203;1759;1930;171;25/02/2021;202104;60;DOM
11220029;1708090016;4318;4612;294;25/02/2021;202104;60;DOM
11220035;1708090291;2363;2570;207;25/02/2021;202104;60;DOM
11220036;1708090294;4632;4927;295;25/02/2021;202104;60;DOM
11220037;1708090301;5233;5406;173;25/02/2021;202104;60;DOM
11220039;3468;30847;31529;682;25/02/2021;202104;60;PROD
11220040;1,43E+11;3228;3480;252;25/02/2021;202104;60;DOM
11220041;141826388;1151;1269;118;25/02/2021;202104;60;DOM
11220042;141826458;2050;2068;18;25/02/2021;202104;60;DOM
11220043;2,02E+11;455;501;46;25/02/2021;202104;60;DOM
11220044;141826463;2520;2785;265;25/02/2021;202104;60;DOM
11220045;141826460;4956;5272;316;25/02/2021;202104;60;DOM
11220046;82369390;1079;1260;181;25/02/2021;202104;60;DOM
11220047;141826459;1390;1395;5;25/02/2021;202104;60;DOM
11220048;141826415;3026;3236;210;25/02/2021;202104;60;DOM
11220049;2,02E+11;3408;3755;347;25/02/2021;202104;60;DOM
11220051;82369567;1839;2088;249;25/02/2021;202104;60;DOM
11220053;82368487;685;736;51;25/02/2021;202104;60;DOM
11220054;82369052;2364;2609;245;25/02/2021;202104;60;DOM
11220055;37219578566;96;139;43;25/02/2021;202104;60;DOM
11220056;82368894;619;730;111;25/02/2021;202104;60;DOM
11220057;82367985;5223;5804;581;25/02/2021;202104;60;DOM
11220058;82368738;2200;2215;15;25/02/2021;202104;60;DOM
11220059;82369037;1728;1838;110;25/02/2021;202104;60;DOM
11220060;82368918;2504;2549;45;25/02/2021;202104;60;DOM
11220062;82368304;1679;1969;290;25/02/2021;202104;60;DOM
11220063;82368151;1762;2302;540;25/02/2021;202104;60;DOM
11220064;82369419;105;112;7;25/02/2021;202104;60;DOM
11220065;82369336;3118;3341;223;25/02/2021;202104;60;DOM
11220066;82369511;2918;3248;330;25/02/2021;202104;60;DOM
11220067;82369640;408;447;39;25/02/2021;202104;60;DOM
11220068;82368584;2330;2751;421;25/02/2021;202104;60;DOM
11220069;82368946;22;58;36;25/02/2021;202104;60;DOM
11220070;82368290;250;252;2;25/02/2021;202104;60;DOM
11220071;82448751;53;60;7;25/02/2021;202104;60;DOM
11220074;82368055;573;643;70;25/02/2021;202104;60;DOM
11220075;82369157;2004;2190;186;25/02/2021;202104;60;DOM
11220076;37219577659;967;1187;220;25/02/2021;202104;60;DOM
11220077;82449268;247;273;26;25/02/2021;202104;60;DOM
11220078;14250517753;1776;1785;9;25/02/2021;202104;60;DOM
11220079;82368951;325;371;46;25/02/2021;202104;60;DOM
11220080;37219578988;13;17;4;25/02/2021;202104;60;DOM
11220081;82448735;235;283;48;25/02/2021;202104;60;DOM
11220082;41237557;5427;6001;574;25/02/2021;202104;60;PROD
11220083;41237535;8885;9779;894;25/02/2021;202104;60;PROD
11220084;41235961;4502;4967;465;25/02/2021;202104;60;PROD
11220085;82449266;3303;3820;517;25/02/2021;202104;60;DOM
11220086;82449263;443;470;27;25/02/2021;202104;60;DOM
11220088;82449284;1153;1336;183;25/02/2021;202104;60;DOM
11220089;82449278;683;779;96;25/02/2021;202104;60;DOM
11220090;82449299;736;918;182;25/02/2021;202104;60;DOM
11220091;82449040;1024;1077;53;25/02/2021;202104;60;DOM
11220092;37219572254;2035;2956;921;25/02/2021;202104;60;DOM
11220094;37219577311;29;38;9;25/02/2021;202104;60;DOM
11220097;37219571975;25;31;6;25/02/2021;202104;60;DOM
11220098;37219574185;135;153;18;25/02/2021;202104;60;DOM
11220099;37219578269;1275;1520;245;25/02/2021;202104;60;DOM
11220100;82449881;982;1452;470;25/02/2021;202104;60;DOM
11220102;37219571255;126;194;68;25/02/2021;202104;60;DOM
11220103;37219574433;580;683;103;25/02/2021;202104;60;DOM
11220105;37219571462;247;320;73;25/02/2021;202104;60;DOM
11220106;37219577196;36;135;99;25/02/2021;202104;60;DOM
11220107;37219577170;0;0;0;25/02/2021;202104;60;DOM
11220108;37219577204;90;110;20;25/02/2021;202104;60;DOM
11220109;37219578335;29;47;18;25/02/2021;202104;60;DOM
11224001;82450490;1390;1577;187;25/02/2021;202104;60;DOM
11224011;37219573252;0;25;25;25/02/2021;202104;60;DOM
11228012;82449703;370;446;76;25/02/2021;202104;60;DOM
11229021;1708090299;3942;4089;147;25/02/2021;202104;60;DOM
11229022;11229022-int;3350;4038;688;25/02/2021;202104;60;DOM
11229023;1708080039;5845;6399;554;25/02/2021;202104;60;DOM
11229024;1708090042;1519;1602;83;25/02/2021;202104;60;DOM
11229025;1708090040;2653;2820;167;25/02/2021;202104;60;DOM
11229026;41235938;6270;6800;530;25/02/2021;202104;60;PROD
11229027;82449023;2647;2826;179;25/02/2021;202104;60;DOM
11229028;82448826;847;886;39;25/02/2021;202104;60;DOM
11229029;82449012;129;144;15;25/02/2021;202104;60;DOM
11229033;41290231;574;723;149;25/02/2021;202104;60;PROD
11229034;82449681;231;356;125;25/02/2021;202104;60;DOM
11229035;37219578749;67;105;38;25/02/2021;202104;60;DOM
11308001;82368647;333;360;27;25/02/2021;202104;60;DOM
11308002;141826443;5327;5800;473;25/02/2021;202104;60;DOM
11308003;14250516565;2331;2613;282;25/02/2021;202104;60;DOM
11308004;141826444;491;509;18;25/02/2021;202104;60;DOM
11308005;82449891;253;397;144;25/02/2021;202104;60;DOM
11308006;141826445;1980;2018;38;25/02/2021;202104;60;DOM
11308007;14250515245;2169;2491;322;25/02/2021;202104;60;DOM
11308008;82368898;1515;1775;260;25/02/2021;202104;60;DOM
11308009;82368694;97;104;7;25/02/2021;202104;60;DOM
11308010;82368702;5260;5711;451;25/02/2021;202104;60;DOM
11308011;141826447;10083;10910;827;25/02/2021;202104;60;DOM
11308012;82368982;1674;1771;97;25/02/2021;202104;60;DOM
11308013;141826446;2771;2921;150;25/02/2021;202104;60;DOM
11308014;14250505675;4368;4681;313;25/02/2021;202104;60;DOM
11308015;37219571884;25;44;19;25/02/2021;202104;60;DOM
11308016;141826438;1295;1417;122;25/02/2021;202104;60;DOM
11308017;82368969;3272;3435;163;25/02/2021;202104;60;DOM
11308018;82368678;660;705;45;25/02/2021;202104;60;DOM
11308019;82368524;2381;2538;157;25/02/2021;202104;60;DOM
11308023;82368855;46;76;30;25/02/2021;202104;60;DOM
11308024;82368517;1992;2117;125;25/02/2021;202104;60;DOM
11308025;82368574;1780;1960;180;25/02/2021;202104;60;DOM
11308026;82368352;1115;1249;134;25/02/2021;202104;60;DOM
11308027;82449493;686;779;93;25/02/2021;202104;60;DOM
11308028;82368477;160;175;15;25/02/2021;202104;60;DOM
11308029;82368686;3068;3235;167;25/02/2021;202104;60;DOM
11308030;82368516;37;46;9;25/02/2021;202104;60;DOM
11308031;82369583;170;189;19;25/02/2021;202104;60;DOM
11308032;82368569;1091;1169;78;25/02/2021;202104;60;DOM
11308034;82369498;3379;3707;328;25/02/2021;202104;60;DOM
11308035;82368995;2177;2179;2;25/02/2021;202104;60;DOM
11308036;82369522;86;96;10;25/02/2021;202104;60;DOM
11308037;82449212;1435;1600;165;25/02/2021;202104;60;DOM
11308038;82449221;1148;1306;158;25/02/2021;202104;60;DOM
11308039;82450531;50;57;7;25/02/2021;202104;60;DOM
11308040;82369020;137;149;12;25/02/2021;202104;60;DOM
11308041;82368927;2084;2106;22;25/02/2021;202104;60;DOM
11308042;3721957113;26;35;9;25/02/2021;202104;60;DOM
11308043;82368974;1667;1875;208;25/02/2021;202104;60;DOM
11308045;82368331;171;175;4;25/02/2021;202104;60;DOM
11308046;82368561;2226;2323;97;25/02/2021;202104;60;DOM
11308048;37219568229;9;99;90;25/02/2021;202104;60;DOM
11308049;82369030;1093;1304;211;25/02/2021;202104;60;DOM
11308050;82449280;111;129;18;25/02/2021;202104;60;DOM
11308051;82368417;113;123;10;25/02/2021;202104;60;DOM
11308052;82368526;54;58;4;25/02/2021;202104;60;DOM
11308054;37219571744;61;141;80;25/02/2021;202104;60;DOM
11308057;82449558;146;165;19;25/02/2021;202104;60;DOM
11308058;82449250;108;257;149;25/02/2021;202104;60;DOM
11308063;82369022;282;309;27;25/02/2021;202104;60;DOM
11308064;82369044;1859;1889;30;25/02/2021;202104;60;DOM
11308065;37219571595;122;231;109;25/02/2021;202104;60;DOM
11308066;82368547;1808;1826;18;25/02/2021;202104;60;DOM
11308067;82368864;818;819;1;25/02/2021;202104;60;PROD
11308068;82369019;449;473;24;25/02/2021;202104;60;PROD
11308069;82368611;101;115;14;25/02/2021;202104;60;DOM
11308070;82369064;3924;3999;75;25/02/2021;202104;60;DOM
11308072;82449230;67;96;29;25/02/2021;202104;60;DOM
11308073;82449472;96;113;17;25/02/2021;202104;60;DOM
11308074;82449518;755;909;154;25/02/2021;202104;60;DOM
11308076;82449514;308;474;166;25/02/2021;202104;60;DOM
11308077;41236447;3833;4093;260;25/02/2021;202104;60;PROD
11308078;41290381;10167;10910;743;25/02/2021;202104;60;PROD
11308079;82449300;96;109;13;25/02/2021;202104;60;DOM
11308080;41290390;7028;7685;657;25/02/2021;202104;60;PROD
11308085;70002940503;0;342;342;25/02/2021;202104;60;PROD
11308086;37219572312;121;255;134;25/02/2021;202104;60;DOM
11308087;37219574094;285;357;72;25/02/2021;202104;60;DOM
11311001;82450451;1597;1759;162;25/02/2021;202104;60;DOM
11413001;82368659;3990;4590;600;25/02/2021;202104;60;DOM
11413002;141826432;354;379;25;25/02/2021;202104;60;DOM
11413003;82369852;1357;1505;148;25/02/2021;202104;60;DOM
11413004;82369868;267;290;23;25/02/2021;202104;60;DOM
11413005;82369710;692;741;49;25/02/2021;202104;60;DOM
11413006;37219571256;38;77;39;25/02/2021;202104;60;DOM
11413008;82369826;822;886;64;25/02/2021;202104;60;DOM
11413009;82369729;365;491;126;25/02/2021;202104;60;DOM
11413010;3721957498;168;218;50;25/02/2021;202104;60;DOM
11413011;82368289;1437;1503;66;25/02/2021;202104;60;DOM
11413013;82369767;2292;2528;236;25/02/2021;202104;60;DOM
11413015;41236305;5548;5957;409;25/02/2021;202104;60;PROD
11413016;82450379;96;104;8;25/02/2021;202104;60;DOM
11413017;82448566;25;32;7;25/02/2021;202104;60;DOM
11413018;82448640;32;38;6;25/02/2021;202104;60;DOM
11413019;37219570365;8;10;2;25/02/2021;202104;60;DOM
11413020;37219570787;6;8;2;25/02/2021;202104;60;DOM
11413021;37219575207;10;15;5;25/02/2021;202104;60;DOM
11413022;37219571876;10;15;5;25/02/2021;202104;60;DOM
11413023;37219572106;62;80;18;25/02/2021;202104;60;DOM
11413024;37219570878;22;28;6;25/02/2021;202104;60;DOM
11414001;6465;3100;3315;215;25/02/2021;202104;60;DOM
11414002;37219570035;64;86;22;25/02/2021;202104;60;DOM
11414003;82369212;205;226;21;25/02/2021;202104;60;DOM
11414004;82369712;1548;1608;60;25/02/2021;202104;60;DOM
11414005;37219571116;37;49;12;25/02/2021;202104;60;DOM
11414006;37219574243;39;50;11;25/02/2021;202104;60;DOM
11416001;141826424;1859;1884;25;25/02/2021;202104;60;DOM
11416002;82368799;284;306;22;25/02/2021;202104;60;DOM
11416003;82449178;82;93;11;25/02/2021;202104;60;DOM
11416004;82369296;1625;1691;66;25/02/2021;202104;60;DOM
11416005;141826425;2158;2353;195;25/02/2021;202104;60;DOM
11416006;82369748;970;1107;137;25/02/2021;202104;60;DOM
11416007;82369191;121;132;11;25/02/2021;202104;60;DOM
11416008;37219560291;25;31;6;25/02/2021;202104;60;DOM
11416009;37219560093;23;29;6;25/02/2021;202104;60;DOM
11416010;82449005;69;82;13;25/02/2021;202104;60;DOM
11416011;82448589;898;1027;129;25/02/2021;202104;60;DOM
11416012;82368059;1035;1130;95;25/02/2021;202104;60;DOM
11416013;82365857;1086;1296;210;25/02/2021;202104;60;DOM
11416014;37219560085;29;35;6;25/02/2021;202104;60;DOM
11416015;82369818;45;50;5;25/02/2021;202104;60;DOM
11416016;82369856;29;31;2;25/02/2021;202104;60;DOM
11416017;82368743;149;163;14;25/02/2021;202104;60;DOM
11416018;41236471;2488;2695;207;25/02/2021;202104;60;PROD
11416019;82448728;106;119;13;25/02/2021;202104;60;DOM
11420009;82350373;11045;12162;1117;25/02/2021;202104;60;DOM
11422001;37219569953;24;30;6;25/02/2021;202104;60;DOM
11422002;1604214699;1330;1383;53;25/02/2021;202104;60;DOM
11422003;3325;5576;5808;232;25/02/2021;202104;60;DOM
11422004;141826366;6588;7028;440;25/02/2021;202104;60;DOM
11422006;4808;5664;6053;389;25/02/2021;202104;60;DOM
11422007;140826427;2134;2318;184;25/02/2021;202104;60;DOM
11422008;4661;3394;3635;241;25/02/2021;202104;60;DOM
11422009;14250514545;5214;5467;253;25/02/2021;202104;60;DOM
11422010;5205;2712;2840;128;25/02/2021;202104;60;DOM
11422011;4806;5288;5541;253;25/02/2021;202104;60;DOM
11422012;141826426;1411;1460;49;25/02/2021;202104;60;DOM
11422013;141826462;2520;2626;106;25/02/2021;202104;60;DOM
11422014;1604213235;6001;6111;110;25/02/2021;202104;60;DOM
11422015;141826467;3226;3371;145;25/02/2021;202104;60;DOM
11422016;82368706;306;480;174;25/02/2021;202104;60;DOM
11422017;141826365;1349;1426;77;25/02/2021;202104;60;DOM
11422018;170505238;1864;1933;69;25/02/2021;202104;60;DOM
11422019;141826440;2535;2671;136;25/02/2021;202104;60;DOM
11422020;5776;3677;3850;173;25/02/2021;202104;60;DOM
11422021;141826441;552;635;83;25/02/2021;202104;60;DOM
11422022;3290;2314;2424;110;25/02/2021;202104;60;DOM
11422023;82449602;823;1186;363;25/02/2021;202104;60;DOM
11422024;3751;1764;1845;81;25/02/2021;202104;60;DOM
11422025;82449821;68;85;17;25/02/2021;202104;60;DOM
11422026;141826396;388;419;31;25/02/2021;202104;60;DOM
11422027;141826442;1076;1212;136;25/02/2021;202104;60;DOM
11422028;1604213652;1950;2097;147;25/02/2021;202104;60;DOM
11422029;141826437;107;125;18;25/02/2021;202104;60;DOM
11422030;1604213861;259;296;37;25/02/2021;202104;60;DOM
11422031;14250515294;2834;2940;106;25/02/2021;202104;60;DOM
11422032;82368711;534;572;38;25/02/2021;202104;60;DOM
11422033;14250516573;5516;6206;690;25/02/2021;202104;60;DOM
11422034;82369727;633;648;15;25/02/2021;202104;60;DOM
11422035;82369816;1756;1923;167;25/02/2021;202104;60;DOM
11422037;82366709;2683;2867;184;25/02/2021;202104;60;DOM
11422038;82368136;2645;2834;189;25/02/2021;202104;60;DOM
11422039;37219560283;46;59;13;25/02/2021;202104;60;DOM
11422040;37219559871;15;22;7;25/02/2021;202104;60;DOM
11422041;82449232;568;601;33;25/02/2021;202104;60;DOM
11422042;82368268;1483;1712;229;25/02/2021;202104;60;DOM
11422043;82368412;379;422;43;25/02/2021;202104;60;DOM
11422044;82368703;363;430;67;25/02/2021;202104;60;DOM
11422045;82368609;212;229;17;25/02/2021;202104;60;DOM
11422046;82367660;1308;1353;45;25/02/2021;202104;60;DOM
11422047;82368271;585;775;190;25/02/2021;202104;60;DOM
11422048;82368007;774;850;76;25/02/2021;202104;60;DOM
11422049;82368403;1803;1866;63;25/02/2021;202104;60;DOM
11422050;82367680;340;343;3;25/02/2021;202104;60;DOM
11422052;82367983;507;571;64;25/02/2021;202104;60;DOM
11422053;82367999;2472;2696;224;25/02/2021;202104;60;DOM
11422055;82449460;609;672;63;25/02/2021;202104;60;DOM
11422056;82367955;1049;1072;23;25/02/2021;202104;60;DOM
11422058;82369226;1104;1118;14;25/02/2021;202104;60;DOM
11422059;82368710;861;903;42;25/02/2021;202104;60;DOM
11422060;82450394;1272;1445;173;25/02/2021;202104;60;DOM
11422061;82448558;1754;2056;302;25/02/2021;202104;60;DOM
11422062;82449270;37;48;11;25/02/2021;202104;60;DOM
11422063;82368298;2513;2541;28;25/02/2021;202104;60;DOM
11422066;82368196;1617;1764;147;25/02/2021;202104;60;DOM
11422067;82368640;505;552;47;25/02/2021;202104;60;DOM
11422068;82449104;569;593;24;25/02/2021;202104;60;DOM
11422069;82367870;202;219;17;25/02/2021;202104;60;DOM
11422070;37219560416;19;26;7;25/02/2021;202104;60;DOM
11422071;82449431;16;20;4;25/02/2021;202104;60;DOM
11422072;82449310;1592;1766;174;25/02/2021;202104;60;DOM
11422073;82449276;985;1115;130;25/02/2021;202104;60;DOM
11422074;82449287;44;132;88;25/02/2021;202104;60;DOM
11422075;82448569;81;92;11;25/02/2021;202104;60;DOM
11422076;82368724;2317;2455;138;25/02/2021;202104;60;DOM
11422077;82369821;306;337;31;25/02/2021;202104;60;DOM
11422080;82368675;1205;1252;47;25/02/2021;202104;60;DOM
11422081;82448680;971;1106;135;25/02/2021;202104;60;DOM
11422082;82368305;1652;1909;257;25/02/2021;202104;60;DOM
11422083;82368003;1709;1898;189;25/02/2021;202104;60;DOM
11422084;82449944;416;448;32;25/02/2021;202104;60;DOM
11422085;82448961;225;265;40;25/02/2021;202104;60;DOM
11422086;82368388;943;1042;99;25/02/2021;202104;60;DOM
11422087;82369751;670;777;107;25/02/2021;202104;60;DOM
11422088;70002900499;0;2;2;25/02/2021;202104;60;DOM
11422089;82450170;17;18;1;25/02/2021;202104;60;DOM
11422090;82450458;1119;1277;158;25/02/2021;202104;60;DOM
11422091;82449219;102;119;17;25/02/2021;202104;60;DOM
11422092;82362291;460;501;41;25/02/2021;202104;60;DOM
11422093;82368048;1276;1318;42;25/02/2021;202104;60;DOM
11422094;82448827;910;1080;170;25/02/2021;202104;60;DOM
11422095;82368014;1545;1706;161;25/02/2021;202104;60;DOM
11422096;82448584;142;304;162;25/02/2021;202104;60;DOM
11422097;82369736;137;151;14;25/02/2021;202104;60;DOM
11422098;82450016;34;44;10;25/02/2021;202104;60;DOM
11422099;82368019;1034;1066;32;25/02/2021;202104;60;DOM
11422100;82449513;652;723;71;25/02/2021;202104;60;DOM
11422101;82368612;1427;1497;70;25/02/2021;202104;60;DOM
11422106;82367967;1107;1255;148;25/02/2021;202104;60;DOM
11422108;82369192;1909;2009;100;25/02/2021;202104;60;DOM
11422109;82368608;2019;2193;174;25/02/2021;202104;60;DOM
11422110;41236428;14931;15871;940;25/02/2021;202104;60;PROD
11422111;82368217;1234;1263;29;25/02/2021;202104;60;DOM
11422113;82369339;89;140;51;25/02/2021;202104;60;DOM
11422114;82369401;240;302;62;25/02/2021;202104;60;DOM
11422115;37219572114;308;347;39;25/02/2021;202104;60;DOM
11422116;82450507;233;259;26;25/02/2021;202104;60;DOM
11422117;82448734;117;142;25;25/02/2021;202104;60;DOM
11422118;41236256;6768;7548;780;25/02/2021;202104;60;PROD
11422119;82448642;232;277;45;25/02/2021;202104;60;DOM
11422120;82450354;511;642;131;25/02/2021;202104;60;DOM
11422121;82449261;187;212;25;25/02/2021;202104;60;DOM
11422122;82368592;14;18;4;25/02/2021;202104;60;DOM
11422123;82448603;140;181;41;25/02/2021;202104;60;DOM
11422124;37219570431;130;190;60;25/02/2021;202104;60;DOM
11422125;82449379;702;712;10;25/02/2021;202104;60;DOM
11422126;82369003;712;812;100;25/02/2021;202104;60;DOM
11422128;41236419;5555;6135;580;25/02/2021;202104;60;PROD
11422130;82450018;356;381;25;25/02/2021;202104;60;DOM
11422131;82450409;538;672;134;25/02/2021;202104;60;DOM
11422133;41238117;1501;1683;182;25/02/2021;202104;60;PROD
11422134;82450219;318;355;37;25/02/2021;202104;60;DOM
11422135;41290353;1792;2084;292;25/02/2021;202104;60;PROD
11422136;82449588;809;975;166;25/02/2021;202104;60;DOM
11422137;82450372;618;784;166;25/02/2021;202104;60;DOM
11422138;82450333;143;155;12;25/02/2021;202104;60;DOM
11422139;82450466;18;24;6;25/02/2021;202104;60;DOM
11422140;82449094;278;455;177;25/02/2021;202104;60;DOM
11422141;82450416;99;121;22;25/02/2021;202104;60;DOM
11422142;82449192;892;1010;118;25/02/2021;202104;60;DOM
11422143;82450218;141;167;26;25/02/2021;202104;60;DOM
11422144;82449155;1116;1368;252;25/02/2021;202104;60;DOM
11422145;1604215234;260;296;36;25/02/2021;202104;60;DOM
11422146;82450534;199;237;38;25/02/2021;202104;60;DOM
11422147;82450513;188;290;102;25/02/2021;202104;60;DOM
11422148;82448648;175;190;15;25/02/2021;202104;60;DOM
11422149;37219570837;26;36;10;25/02/2021;202104;60;DOM
11422150;82449180;1468;1498;30;25/02/2021;202104;60;DOM
11422151;82448661;1362;1505;143;25/02/2021;202104;60;DOM
11422152;82449613;237;264;27;25/02/2021;202104;60;DOM
11422153;82449138;40;42;2;25/02/2021;202104;60;DOM
11422154;82449140;1183;1341;158;25/02/2021;202104;60;DOM
11422155;82449407;199;249;50;25/02/2021;202104;60;DOM
11422156;82449093;102;218;116;25/02/2021;202104;60;DOM
11422157;82449962;1595;1950;355;25/02/2021;202104;60;DOM
11422158;37219572072;0;1;1;25/02/2021;202104;60;DOM
11422159;37219572122;404;535;131;25/02/2021;202104;60;DOM
11422160;82449025;120;135;15;25/02/2021;202104;60;DOM
11422161;37219571850;330;613;283;25/02/2021;202104;60;DOM
11422162;37219560267;736;884;148;25/02/2021;202104;60;DOM
11422163;37219572163;5;25;20;25/02/2021;202104;60;DOM
11422164;70002940883;0;30;30;25/02/2021;202104;60;PROD
11422165;37219572130;48;74;26;25/02/2021;202104;60;DOM
11422166;37219560101;1049;1221;172;25/02/2021;202104;60;DOM
11422169;70002940214;0;336;336;25/02/2021;202104;60;PROD
11422170;37219570829;22;31;9;25/02/2021;202104;60;DOM
11422172;37219572155;10;12;2;25/02/2021;202104;60;DOM
11422174;70002942111;0;1350;1350;25/02/2021;202104;60;PROD
11422176;37219560952;12;19;7;25/02/2021;202104;60;DOM
11422177;37219569508;15;20;5;25/02/2021;202104;60;DOM
11422178;37219570639;23;39;16;25/02/2021;202104;60;DOM
11422179;37219560903;15;25;10;25/02/2021;202104;60;DOM
11422181;37219570670;44;57;13;25/02/2021;202104;60;DOM
11422183;37219559988;541;718;177;25/02/2021;202104;60;DOM
11422184;37219570746;121;199;78;25/02/2021;202104;60;DOM
11422185;37219570654;765;992;227;25/02/2021;202104;60;DOM
11422195;41290134;0;1508;1508;25/02/2021;202104;60;PROD
11422198;70002939901;0;31;31;25/02/2021;202104;60;PROD
11423001;82448561;28;50;22;25/02/2021;202104;60;DOM
11423003;41289941;3683;4192;509;25/02/2021;202104;60;PROD
11425001;82449246;49;55;6;25/02/2021;202104;60;DOM
11425003;82369338;628;753;125;25/02/2021;202104;60;DOM
11425006;141826400;4546;4847;301;25/02/2021;202104;60;DOM
11425007;141826399;4385;4701;316;25/02/2021;202104;60;DOM
11425008;141826405;5667;6032;365;25/02/2021;202104;60;DOM
11425009;141826401;1019;1121;102;25/02/2021;202104;60;DOM
11425010;82448758;31;39;8;25/02/2021;202104;60;DOM
11425011;37219571199;82;102;20;25/02/2021;202104;60;DOM
11425013;82449274;570;670;100;25/02/2021;202104;60;DOM
11425015;82449355;1070;1159;89;25/02/2021;202104;60;DOM
11425016;141826398;2394;2539;145;25/02/2021;202104;60;DOM
11425017;82450455;79;101;22;25/02/2021;202104;60;DOM
11425018;37219569054;10;20;10;25/02/2021;202104;60;DOM
11425020;37219568385;52;67;15;25/02/2021;202104;60;DOM
11425021;82448779;31;46;15;25/02/2021;202104;60;DOM
11425023;141826404;241;339;98;25/02/2021;202104;60;DOM
11425024;82449370;856;971;115;25/02/2021;202104;60;DOM
11425025;82449194;128;155;27;25/02/2021;202104;60;DOM
11425026;82449107;1250;1292;42;25/02/2021;202104;60;DOM
11425028;82449262;38;43;5;25/02/2021;202104;60;DOM
11425029;82449352;1290;1403;113;25/02/2021;202104;60;DOM
11425030;82450269;40;48;8;25/02/2021;202104;60;DOM
11425031;37219571330;20;26;6;25/02/2021;202104;60;DOM
11425032;37219570951;1123;1308;185;25/02/2021;202104;60;DOM
11425033;37219571108;746;855;109;25/02/2021;202104;60;DOM
11425036;70002940719;0;5;5;25/02/2021;202104;60;PROD
11425038;70002942350;0;5;5;25/02/2021;202104;60;PROD
11425039;37219576883;132;198;66;25/02/2021;202104;60;DOM
11425040;37219576925;169;251;82;25/02/2021;202104;60;DOM
11425041;37219576909;6;13;7;25/02/2021;202104;60;DOM
11425042;37219576917;4;6;2;25/02/2021;202104;60;DOM
11425043;37219571212;28;35;7;25/02/2021;202104;60;DOM
11433002;82369726;2155;2273;118;25/02/2021;202104;60;DOM
11433003;82369251;1669;1810;141;25/02/2021;202104;60;DOM
11433004;1826364;1438;1488;50;25/02/2021;202104;60;DOM
11433006;82448650;49;55;6;25/02/2021;202104;60;DOM
11433007;82448567;188;219;31;25/02/2021;202104;60;DOM
11433008;82448983;874;1002;128;25/02/2021;202104;60;DOM
11433010;70002942368;0;5;5;25/02/2021;202104;60;PROD
11433011;70002936931;0;1;1;25/02/2021;202104;60;DOM
11434001;82448698;745;791;46;25/02/2021;202104;60;DOM
11434005;82369194;2277;2402;125;25/02/2021;202104;60;DOM
11434006;82448597;45;55;10;25/02/2021;202104;60;DOM
11436001;37219570852;25;34;9;25/02/2021;202104;60;DOM
11436002;82368028;1436;1560;124;25/02/2021;202104;60;DOM
11436004;82449068;53;66;13;25/02/2021;202104;60;DOM
11436005;82369337;487;491;4;25/02/2021;202104;60;DOM
11436007;82450321;41;47;6;25/02/2021;202104;60;DOM
11436008;82367971;67;72;5;25/02/2021;202104;60;DOM
11436009;37219570530;330;464;134;25/02/2021;202104;60;DOM
11436010;82450430;240;245;5;25/02/2021;202104;60;DOM
11436011;82367993;912;927;15;25/02/2021;202104;60;DOM
11436012;70002941998;0;49;49;25/02/2021;202104;60;PROD
11444003;82449386;206;238;32;25/02/2021;202104;60;DOM
11444006;82449941;28;33;5;25/02/2021;202104;60;DOM
11445001;14225393751;23700;24808;1108;25/02/2021;202104;60;PROD
11445002;82449255;262;296;34;25/02/2021;202104;60;DOM
11445003;3834;273;293;20;25/02/2021;202104;60;DOM
11445004;82449297;967;1053;86;25/02/2021;202104;60;DOM
11445005;1604215816;4000;4139;139;25/02/2021;202104;60;DOM
11445006;1604213894;531;566;35;25/02/2021;202104;60;DOM
11445007;1604214807;2910;3131;221;25/02/2021;202104;60;DOM
11445008;1604215228;3227;3606;379;25/02/2021;202104;60;DOM
11445009;1604214794;328;341;13;25/02/2021;202104;60;DOM
11445010;1604213697;288;308;20;25/02/2021;202104;60;DOM
11445011;1604215677;2181;2297;116;25/02/2021;202104;60;DOM
11445012;1604214458;4701;4926;225;25/02/2021;202104;60;DOM
11445013;170506067;4457;4761;304;25/02/2021;202104;60;DOM
11445014;1604215813;3594;3744;150;25/02/2021;202104;60;DOM
11445015;2,02E+11;1482;1510;28;25/02/2021;202104;60;DOM
11445016;170506854;2894;3090;196;25/02/2021;202104;60;DOM
11445018;3794;3609;3797;188;25/02/2021;202104;60;DOM
11445019;1604214801;483;498;15;25/02/2021;202104;60;DOM
11445020;1604215231;6234;6556;322;25/02/2021;202104;60;DOM
11445021;1604213236;4866;5054;188;25/02/2021;202104;60;DOM
11445022;1604214830;3675;3814;139;25/02/2021;202104;60;DOM
11445024;1604214816;3556;3746;190;25/02/2021;202104;60;DOM
11445025;170506996;2865;3077;212;25/02/2021;202104;60;DOM
11445026;5685;2407;2586;179;25/02/2021;202104;60;DOM
11445027;2,02E+11;1145;1190;45;25/02/2021;202104;60;DOM
11445028;170505855;5600;5714;114;25/02/2021;202104;60;DOM
11445029;1604215303;691;735;44;25/02/2021;202104;60;DOM
11445030;5679;139;142;3;25/02/2021;202104;60;DOM
11445031;5295;1582;1672;90;25/02/2021;202104;60;DOM
11445032;1604213759;284;309;25;25/02/2021;202104;60;DOM
11445033;5823;1755;1880;125;25/02/2021;202104;60;DOM
11445034;1604213765;1806;1813;7;25/02/2021;202104;60;DOM
11445035;14225394775;7126;7126;0;25/02/2021;202104;60;PROD
11445036;41236487;2027;2915;888;25/02/2021;202104;60;PROD
11445037;2,02E+11;1893;2445;552;25/02/2021;202104;60;DOM
11445038;2,02E+11;518;611;93;25/02/2021;202104;60;DOM
11445039;2,02E+11;3696;4044;348;25/02/2021;202104;60;DOM
11445040;82369820;1072;1088;16;25/02/2021;202104;60;DOM
11445041;37219571009;61;87;26;25/02/2021;202104;60;DOM
11445042;82450040;1231;1401;170;25/02/2021;202104;60;DOM
11445043;82369399;910;949;39;25/02/2021;202104;60;DOM
11445044;82449000;78;86;8;25/02/2021;202104;60;DOM
11445045;82369786;2335;2411;76;25/02/2021;202104;60;DOM
11445046;82449253;649;666;17;25/02/2021;202104;60;DOM
11445047;82449216;360;393;33;25/02/2021;202104;60;DOM
11445048;82450059;174;200;26;25/02/2021;202104;60;DOM
11445049;82369348;1272;1397;125;25/02/2021;202104;60;DOM
11445050;82369371;690;706;16;25/02/2021;202104;60;DOM
11445051;82369944;2459;2608;149;25/02/2021;202104;60;DOM
11445052;82369283;2015;2015;0;25/02/2021;202104;60;DOM
11445053;82369563;1106;1133;27;25/02/2021;202104;60;DOM
11445054;82449337937;29;29;0;25/02/2021;202104;60;DOM
11445055;82369236;2561;2758;197;25/02/2021;202104;60;DOM
11445057;82449367;1615;2085;470;25/02/2021;202104;60;DOM
11445058;82365886;2015;2214;199;25/02/2021;202104;60;DOM
11445059;82449727;62;76;14;25/02/2021;202104;60;DOM
11445060;82448888;437;463;26;25/02/2021;202104;60;DOM
11445061;82369838;439;479;40;25/02/2021;202104;60;DOM
11445062;82369887;451;554;103;25/02/2021;202104;60;DOM
11445063;82369307;486;944;458;25/02/2021;202104;60;DOM
11445064;82449285;114;128;14;25/02/2021;202104;60;DOM
11445065;82369713;184;200;16;25/02/2021;202104;60;DOM
11445066;82368997;317;353;36;25/02/2021;202104;60;DOM
11445067;82449484;403;446;43;25/02/2021;202104;60;DOM
11445069;82369837;1850;1880;30;25/02/2021;202104;60;DOM
11445070;82369335;2248;2743;495;25/02/2021;202104;60;DOM
11445071;82448718;1796;1796;0;25/02/2021;202104;60;DOM
11445072;82450240;2135;2424;289;25/02/2021;202104;60;DOM
11445073;41289675;1582;1761;179;25/02/2021;202104;60;PROD
11445074;41290216;2151;2496;345;25/02/2021;202104;60;PROD
11445075;37219570209;0;389;389;25/02/2021;202104;60;DOM
11445076;82449828;61;74;13;25/02/2021;202104;60;DOM
11445077;82449214;544;618;74;25/02/2021;202104;60;DOM
11445078;82449795;766;872;106;25/02/2021;202104;60;DOM
11445080;37219574334;29;37;8;25/02/2021;202104;60;DOM
11445081;82449516;558;629;71;25/02/2021;202104;60;DOM
11445082;82449973;11;15;4;25/02/2021;202104;60;DOM
11445083;82448673;1610;1825;215;25/02/2021;202104;60;DOM
11445084;41290368;3976;4256;280;25/02/2021;202104;60;PROD
11445085;37219571280;14;21;7;25/02/2021;202104;60;DOM
11445086;37219571314;112;474;362;25/02/2021;202104;60;DOM
11445087;37219578079;53;74;21;25/02/2021;202104;60;DOM
11445088;37219570977;13;14;1;25/02/2021;202104;60;DOM
11445090;37219569359;50;52;2;25/02/2021;202104;60;DOM
11446001;82449480;92;107;15;25/02/2021;202104;60;DOM
11446005;82449234;113;125;12;25/02/2021;202104;60;DOM
11446006;82448883;29;30;1;25/02/2021;202104;60;DOM
11449003;82449275;62;63;1;25/02/2021;202104;60;DOM
11450002;82442021;108;120;12;25/02/2021;202104;60;DOM
11450003;82369557;1278;1293;15;25/02/2021;202104;60;DOM
11451001;3721959707;87;101;14;25/02/2021;202104;60;DOM
11452002;82448543;31;37;6;25/02/2021;202104;60;DOM
11452008;37219569516;14;21;7;25/02/2021;202104;60;DOM
11452009;82448737;24;25;1;25/02/2021;202104;60;DOM
11454001;82449264;170;190;20;25/02/2021;202104;60;DOM
11454002;82369018;1703;1867;164;25/02/2021;202104;60;DOM
11454003;82368954;973;1154;181;25/02/2021;202104;60;DOM
11454004;82368508;8;10;2;25/02/2021;202104;60;DOM
11454005;82449259;75;82;7;25/02/2021;202104;60;DOM
11454006;82368832;29;32;3;25/02/2021;202104;60;DOM
11454007;82449333;2;4;2;25/02/2021;202104;60;DOM
11454008;82448810;73;118;45;25/02/2021;202104;60;DOM
11454009;82449145;47;68;21;25/02/2021;202104;60;DOM
11454010;82450627;765;914;149;25/02/2021;202104;60;DOM
11454011;37219560572;5;10;5;25/02/2021;202104;60;DOM
11503053;1708090093;9193;9611;418;25/02/2021;202104;60;DOM
11503057;37219577550;0;69;69;25/02/2021;202104;60;DOM
11503074;37219560325;759;900;141;25/02/2021;202104;60;DOM
11503081;1708090076;6118;6263;145;25/02/2021;202104;60;DOM
11503083;14225393801;56321;60290;3969;25/02/2021;202104;60;PROD
11503084;141826369;2885;2949;64;25/02/2021;202104;60;DOM
11503085;41236480;1711;1711;0;25/02/2021;202104;60;PROD
11503086;14225393793;13349;14250;901;25/02/2021;202104;60;PROD
11503087;82450317;1355;1572;217;25/02/2021;202104;60;DOM
11503088;37219578624;873;1178;305;25/02/2021;202104;60;DOM
11503089;82450603;304;348;44;25/02/2021;202104;60;DOM
11503090;41289805;2212;2491;279;25/02/2021;202104;60;PROD
11503091;82450708;108;167;59;25/02/2021;202104;60;DOM
11503092;82450685;163;189;26;25/02/2021;202104;60;PROD
11503093;82450421;700;988;288;25/02/2021;202104;60;PROD
11503094;82449984;863;1007;144;25/02/2021;202104;60;DOM
11503097;37219559715;20;28;8;25/02/2021;202104;60;DOM
11503098;37219560275;65;83;18;25/02/2021;202104;60;DOM
11503099;37219572098;194;259;65;25/02/2021;202104;60;DOM
11503100;37219572270;366;428;62;25/02/2021;202104;60;PROD
11537001;82369065;2219;2427;208;25/02/2021;202104;60;DOM
11537004;82368337;1185;1367;182;25/02/2021;202104;60;DOM
11539001;37219572056;9;13;4;25/02/2021;202104;60;DOM
11803008;82449092;890;962;72;25/02/2021;202104;60;DOM
11804007;82449487;342;373;31;25/02/2021;202104;60;DOM
11808001;82368831;274;334;60;25/02/2021;202104;60;DOM
11808002;82368567;901;931;30;25/02/2021;202104;60;DOM
11808003;82448556;297;333;36;25/02/2021;202104;60;DOM
11808004;82448691;36;39;3;25/02/2021;202104;60;DOM
11808005;82448713;80;88;8;25/02/2021;202104;60;DOM
11808006;82450407;938;982;44;25/02/2021;202104;60;DOM
11808009;82448911;253;288;35;25/02/2021;202104;60;DOM
11808010;82368807;290;319;29;25/02/2021;202104;60;DOM
11808011;82450292;1032;1166;134;25/02/2021;202104;60;DOM
11810001;1604214811;1144;1144;0;25/02/2021;202104;60;DOM
11810002;14225394122;5723;5865;142;25/02/2021;202104;60;PROD
11810003;1604213790;2533;2534;1;25/02/2021;202104;60;DOM
11810004;1604213637;2105;2197;92;25/02/2021;202104;60;DOM
11810005;1604215727;10384;10717;333;25/02/2021;202104;60;DOM
11810006;170505572;4837;4970;133;25/02/2021;202104;60;DOM
11810007;82449551;2596;2690;94;25/02/2021;202104;60;DOM
11810008;141826362;1634;1644;10;25/02/2021;202104;60;DOM
11810009;1604214477;1610;1793;183;25/02/2021;202104;60;DOM
11810010;170306-0024;2088;2227;139;25/02/2021;202104;60;DOM
11810011;1703060022;3367;3805;438;25/02/2021;202104;60;DOM
11810012;1703060023;704;704;0;25/02/2021;202104;60;DOM
11810013;1604214788;3519;3649;130;25/02/2021;202104;60;PROD
11810014;14225394718;14966;15394;428;25/02/2021;202104;60;PROD
11810016;4472;563;612;49;25/02/2021;202104;60;DOM
11810017;1604214675;588;608;20;25/02/2021;202104;60;DOM
11810018;141826367;2354;2568;214;25/02/2021;202104;60;DOM
11810019;82449257;709;715;6;25/02/2021;202104;60;DOM
11810020;1604214487;365;391;26;25/02/2021;202104;60;DOM
11810021;141826431;646;698;52;25/02/2021;202104;60;DOM
11810022;4810;1503;1631;128;25/02/2021;202104;60;DOM
11810023;82449281;60;66;6;25/02/2021;202104;60;DOM
11810024;4805;467;482;15;25/02/2021;202104;60;DOM
11810025;141826433;162;165;3;25/02/2021;202104;60;DOM
11810026;5299;2002;2089;87;25/02/2021;202104;60;DOM
11810027;6958;704;815;111;25/02/2021;202104;60;DOM
11810028;82368721;148;169;21;25/02/2021;202104;60;DOM
11810029;82449364;779;787;8;25/02/2021;202104;60;DOM
11810030;4643;850;903;53;25/02/2021;202104;60;DOM
11810031;141826363;965;986;21;25/02/2021;202104;60;DOM
11810032;1,43E+11;1086;1113;27;25/02/2021;202104;60;DOM
11810033;82369356;837;849;12;25/02/2021;202104;60;DOM
11810034;3901;393;420;27;25/02/2021;202104;60;DOM
11810035;170505245;1511;1597;86;25/02/2021;202104;60;DOM
11810036;82369410;1440;1516;76;25/02/2021;202104;60;DOM
11810037;82449315;80;92;12;25/02/2021;202104;60;DOM
11810038;82369057;2029;2050;21;25/02/2021;202104;60;DOM
11810039;141826436;702;711;9;25/02/2021;202104;60;DOM
11810040;170506970;1660;1797;137;25/02/2021;202104;60;DOM
11810041;141826391;227;265;38;25/02/2021;202104;60;DOM
11810042;141826392;40;40;0;25/02/2021;202104;60;DOM
11810043;6484;2377;2443;66;25/02/2021;202104;60;DOM
11810044;37219577337;579;723;144;25/02/2021;202104;60;DOM
11810045;170506489;1652;1682;30;25/02/2021;202104;60;DOM
11810046;37219573476;185;278;93;25/02/2021;202104;60;DOM
11810047;11810047-int;793;915;122;25/02/2021;202104;60;DOM
11810048;170505567;1587;1650;63;25/02/2021;202104;60;DOM
11810049;3882;1303;1338;35;25/02/2021;202104;60;DOM
11810050;82450656;2040;2213;173;25/02/2021;202104;60;DOM
11810051;1703060025;2203;2245;42;25/02/2021;202104;60;DOM
11810052;11810052-int;3784;4044;260;25/02/2021;202104;60;DOM
11810053;1425384338;3002;3002;0;25/02/2021;202104;60;PROD
11810054;170505283;288;293;5;25/02/2021;202104;60;DOM
11810055;14225394767;5138;5233;95;25/02/2021;202104;60;PROD
11810056;14225394809;2598;2613;15;25/02/2021;202104;60;PROD
11810057;82449301;800;914;114;25/02/2021;202104;60;DOM
11810058;11810058-int;2895;3041;146;25/02/2021;202104;60;DOM
11810059;37219567999;13;16;3;25/02/2021;202104;60;DOM
11810060;82449241;44;51;7;25/02/2021;202104;60;DOM
11810061;141826395;118;125;7;25/02/2021;202104;60;DOM
11810062;37219574250;51;75;24;25/02/2021;202104;60;DOM
11810063;41235813;102864;107639;4775;25/02/2021;202104;60;PROD
11810064;37219570084;29;42;13;25/02/2021;202104;60;DOM
11810066;11810066-int;872;943;71;25/02/2021;202104;60;DOM
11810067;1604214449;2278;2337;59;25/02/2021;202104;60;DOM
11810068;82369421;1449;1494;45;25/02/2021;202104;60;DOM
11810069;82369704;230;262;32;25/02/2021;202104;60;DOM
11810070;11810070-int;6908;6942;34;25/02/2021;202104;60;DOM
11810071;411219089;6904;7486;582;25/02/2021;202104;60;PROD
11810072;41235894;184;184;0;25/02/2021;202104;60;PROD
11810073;41235886;324;425;101;25/02/2021;202104;60;PROD
11810074;141826397;269;287;18;25/02/2021;202104;60;DOM
11810075;141826389;306;319;13;25/02/2021;202104;60;DOM
11810076;41289933;0;0;0;25/02/2021;202104;60;PROD
11810077;141826439;1106;1178;72;25/02/2021;202104;60;DOM
11810078;82367830;755;780;25;25/02/2021;202104;60;DOM
11810079;14250516516;158;166;8;25/02/2021;202104;60;DOM
11810080;82369943;3328;3328;0;25/02/2021;202104;60;PROD
11810081;82367922;4700;4975;275;25/02/2021;202104;60;DOM
11810082;82368442;299;312;13;25/02/2021;202104;60;DOM
11810083;82369884;61;67;6;25/02/2021;202104;60;DOM
11810084;14250516508;245;252;7;25/02/2021;202104;60;DOM
11810085;82369691;250;269;19;25/02/2021;202104;60;DOM
11810086;82449167;430;481;51;25/02/2021;202104;60;DOM
11810087;82449368;61;66;5;25/02/2021;202104;60;DOM
11810090;82449371;70;77;7;25/02/2021;202104;60;DOM
11810091;82449201;125;140;15;25/02/2021;202104;60;DOM
11810092;82449404;28;35;7;25/02/2021;202104;60;DOM
11810094;82368671;201;245;44;25/02/2021;202104;60;DOM
11810095;82449441;245;270;25;25/02/2021;202104;60;DOM
11810096;82368029;188;224;36;25/02/2021;202104;60;DOM
11810097;82366985;1126;1130;4;25/02/2021;202104;60;DOM
11810098;82369779;145;153;8;25/02/2021;202104;60;DOM
11810099;82369741;2240;2243;3;25/02/2021;202104;60;DOM
11810100;82449252;20;23;3;25/02/2021;202104;60;DOM
11810102;82449809;78;100;22;25/02/2021;202104;60;DOM
11810103;82368391;1526;1690;164;25/02/2021;202104;60;DOM
11810104;82368094;890;892;2;25/02/2021;202104;60;DOM
11810105;82369772;793;850;57;25/02/2021;202104;60;DOM
11810107;82367996;2104;2238;134;25/02/2021;202104;60;DOM
11810108;82368424;1136;1157;21;25/02/2021;202104;60;DOM
11810109;82368303;315;340;25;25/02/2021;202104;60;DOM
11810110;82368053;500;541;41;25/02/2021;202104;60;DOM
11810111;82449785;60;72;12;25/02/2021;202104;60;DOM
11810112;82449237;197;211;14;25/02/2021;202104;60;DOM
11810113;82449293;14;16;2;25/02/2021;202104;60;DOM
11810114;82448922;670;670;0;25/02/2021;202104;60;DOM
11810115;82368291;227;228;1;25/02/2021;202104;60;DOM
11810116;82368955;208;224;16;25/02/2021;202104;60;DOM
11810117;82368005;120;133;13;25/02/2021;202104;60;DOM
11810118;82448741;1869;1887;18;25/02/2021;202104;60;DOM
11810119;82448849;43;55;12;25/02/2021;202104;60;DOM
11810121;82449128;42;51;9;25/02/2021;202104;60;DOM
11810122;82448753;118;150;32;25/02/2021;202104;60;DOM
11810123;82449360;70;80;10;25/02/2021;202104;60;DOM
11810124;82449114;118;125;7;25/02/2021;202104;60;DOM
11810125;82449217;147;167;20;25/02/2021;202104;60;DOM
11810126;41289992;1785;1964;179;25/02/2021;202104;60;PROD
11810127;82448797;9802;10634;832;25/02/2021;202104;60;DOM
11810128;82449730;68;75;7;25/02/2021;202104;60;DOM
11810129;82450473;54;63;9;25/02/2021;202104;60;DOM
11810130;82449419;32;38;6;25/02/2021;202104;60;DOM
11810131;82450362;77;98;21;25/02/2021;202104;60;DOM
11810132;82450625;164;171;7;25/02/2021;202104;60;DOM
11810134;82449606;443;477;34;25/02/2021;202104;60;DOM
11810138;37219577451;5;5;0;25/02/2021;202104;60;DOM
11810140;37219571801;72;86;14;25/02/2021;202104;60;DOM
11810141;37219570548;33;44;11;25/02/2021;202104;60;DOM
11810142;37219573500;0;298;298;25/02/2021;202104;60;DOM
11810143;37219570712;0;0;0;25/02/2021;202104;60;DOM
11810144;37219570563;16;22;6;25/02/2021;202104;60;DOM
11810145;37219570571;12;15;3;25/02/2021;202104;60;DOM
11810146;37219570845;83;118;35;25/02/2021;202104;60;DOM
11810147;37219570555;800;975;175;25/02/2021;202104;60;DOM
11810150;37219570597;34;44;10;25/02/2021;202104;60;DOM
11810152;37219570738;24;33;9;25/02/2021;202104;60;DOM
11810162;41236472;0;525;525;25/02/2021;202104;60;PROD
11812015;1708090094;4118;4236;118;25/02/2021;202104;60;DOM
11812025;82449056;4473;5086;613;25/02/2021;202104;60;DOM
11812026;37219559699;1495;1865;370;25/02/2021;202104;60;PROD
11814003;1708090115;4430;4501;71;25/02/2021;202104;60;DOM
11814011;170809-0385;2010;2047;37;25/02/2021;202104;60;DOM
11814012;170809-0386;5093;5424;331;25/02/2021;202104;60;DOM
11814017;170809-0396;1405;1521;116;25/02/2021;202104;60;DOM
11814035;82369790;3963;4227;264;25/02/2021;202104;60;DOM
11814036;82448707;365;377;12;25/02/2021;202104;60;DOM
11814038;37219572239;301;304;3;25/02/2021;202104;60;DOM
11819001;82369792;1493;1603;110;25/02/2021;202104;60;DOM
11819002;82449555;1264;1416;152;25/02/2021;202104;60;DOM
11819004;41290039;1196;1401;205;25/02/2021;202104;60;PROD
11819005;37219569748;47;58;11;25/02/2021;202104;60;DOM
11823007;3702;7496;8029;533;25/02/2021;202104;60;PROD
11823009;82449329;1582;1840;258;25/02/2021;202104;60;DOM
11823010;82449533;408;439;31;25/02/2021;202104;60;DOM
11823011;37219570944;95;158;63;25/02/2021;202104;60;DOM
11824001;170809-0398;12881;13370;489;25/02/2021;202104;60;DOM
11824002;1708090091;6811;6941;130;25/02/2021;202104;60;DOM
11824010;82449805;213;229;16;25/02/2021;202104;60;DOM
11824022;41290027;7558;11796;4238;25/02/2021;202104;60;PROD
11824023;37219560747;19;28;9;25/02/2021;202104;60;DOM
11824024;82449633;276;501;225;25/02/2021;202104;60;DOM
11824025;82449394;926;995;69;25/02/2021;202104;60;DOM
11824026;37219560895;66;89;23;25/02/2021;202104;60;DOM
11824027;37219570688;58;101;43;25/02/2021;202104;60;DOM
11824029;37219570605;16;38;22;25/02/2021;202104;60;DOM
11824030;37219578319;21;30;9;25/02/2021;202104;60;DOM
11824033;37219577790;0;8;8;25/02/2021;202104;60;DOM
11824034;37219571439;33;62;29;25/02/2021;202104;60;DOM
11824035;37219568344;0;26;26;25/02/2021;202104;60;DOM
11824036;37219569599;95;181;86;25/02/2021;202104;60;DOM
11824037;37219570266;0;14;14;25/02/2021;202104;60;DOM
11824038;37219570464;84;122;38;25/02/2021;202104;60;DOM
11901004;150303-0182;6805;7054;249;25/02/2021;202104;60;DOM
11901006;150303-0183;9813;10200;387;25/02/2021;202104;60;DOM
11901007;150303-0184;2574;2775;201;25/02/2021;202104;60;DOM
11901008;150303-0181;7570;7857;287;25/02/2021;202104;60;DOM
11901011;150303-0136;9983;10193;210;25/02/2021;202104;60;DOM
11901012;150303-0133;1643;1762;119;25/02/2021;202104;60;DOM
11901013;150303-0163;4574;4683;109;25/02/2021;202104;60;DOM
11901014;150303-0164;4632;4737;105;25/02/2021;202104;60;DOM
11901015;150303-0135;2921;2984;63;25/02/2021;202104;60;DOM
11901016;150303-0162;3682;3769;87;25/02/2021;202104;60;DOM
11901017;82368597;6035;6192;157;25/02/2021;202104;60;DOM
11901020;82368789;14;16;2;25/02/2021;202104;60;DOM
11901023;150303-0061;3675;3834;159;25/02/2021;202104;60;DOM
11901024;150303-0064;5561;5723;162;25/02/2021;202104;60;DOM
11901025;150303-0062;5353;5571;218;25/02/2021;202104;60;DOM
11901026;150303-0161;6631;6816;185;25/02/2021;202104;60;DOM
11901027;150303-0095;1876;2003;127;25/02/2021;202104;60;DOM
11901029;82368664;64;67;3;25/02/2021;202104;60;DOM
11901031;150303-0491;4110;4269;159;25/02/2021;202104;60;DOM
11901033;1708090092;2692;2878;186;25/02/2021;202104;60;DOM
11901034;150303-0489;4048;4228;180;25/02/2021;202104;60;DOM
11901035;170809116;5480;5780;300;25/02/2021;202104;60;DOM
11901036;11901036-int;3622;4534;912;25/02/2021;202104;60;DOM
11901037;1708090117;3593;3690;97;25/02/2021;202104;60;DOM
11901038;1708090003;4999;5029;30;25/02/2021;202104;60;DOM
11901039;1708090005;4888;4891;3;25/02/2021;202104;60;DOM
11901040;1708090397;5492;5730;238;25/02/2021;202104;60;DOM
11901041;41237670;94094;101990;7896;25/02/2021;202104;60;PROD
11901042;1708090320;2241;2301;60;25/02/2021;202104;60;DOM
11901043;1708090075;2403;2449;46;25/02/2021;202104;60;DOM
11901044;1708090078;498;519;21;25/02/2021;202104;60;DOM
11901048;37219569367;0;11;11;25/02/2021;202104;60;DOM
11901050;1704040038;2521;2577;56;25/02/2021;202104;60;DOM
11901052;1708090354;4183;4338;155;25/02/2021;202104;60;DOM
11901053;11901053-int;2420;2527;107;25/02/2021;202104;60;DOM
11901054;1703060011;2554;2641;87;25/02/2021;202104;60;DOM
11901055;1703060013;4361;4889;528;25/02/2021;202104;60;DOM
11901056;17080940036;1828;1960;132;25/02/2021;202104;60;DOM
11901057;1708080020;3859;3975;116;25/02/2021;202104;60;DOM
11901058;11901058-int;976;977;1;25/02/2021;202104;60;DOM
11901059;1708090322;1632;1664;32;25/02/2021;202104;60;DOM
11901061;21;5530;5746;216;25/02/2021;202104;60;DOM
11901062;1708090090;2299;2318;19;25/02/2021;202104;60;DOM
11901063;1708090084;323;339;16;25/02/2021;202104;60;DOM
11901064;1708090086;193;195;2;25/02/2021;202104;60;DOM
11901065;37219572304;13;18;5;25/02/2021;202104;60;DOM
11901069;1708090088;3459;3636;177;25/02/2021;202104;60;DOM
11901070;1708090353;1119;1152;33;25/02/2021;202104;60;DOM
11901071;1708090087;5760;6001;241;25/02/2021;202104;60;DOM
11901072;1708090083;2949;3073;124;25/02/2021;202104;60;DOM
11901073;1708090022;7716;7949;233;25/02/2021;202104;60;DOM
11901074;1708090089;249;279;30;25/02/2021;202104;60;DOM
11901075;1708090019;1852;1888;36;25/02/2021;202104;60;DOM
11901076;1703060010;3130;3369;239;25/02/2021;202104;60;DOM
11901077;1708010351;3981;4215;234;25/02/2021;202104;60;DOM
11901079;1708090319;1851;1933;82;25/02/2021;202104;60;DOM
11901080;1703060012;5931;6075;144;25/02/2021;202104;60;DOM
11901081;1708090085;2755;2816;61;25/02/2021;202104;60;DOM
11901082;1708090077;3796;4024;228;25/02/2021;202104;60;DOM
11901086;82369097;1031;1176;145;25/02/2021;202104;60;PROD
11901088;1708090004;4346;4414;68;25/02/2021;202104;60;DOM
11901089;1708090018;797;848;51;25/02/2021;202104;60;DOM
11901090;11901090-int;4491;4897;406;25/02/2021;202104;60;DOM
11901091;1708090015;7547;7904;357;25/02/2021;202104;60;DOM
11901093;11901093-int;1602;1603;1;25/02/2021;202104;60;DOM
11901095;14225393769;1209;1398;189;25/02/2021;202104;60;PROD
11901098;1708090240;1187;1206;19;25/02/2021;202104;60;DOM
11901099;1708090251;2451;2591;140;25/02/2021;202104;60;DOM
11901100;14225393835;23580;24820;1240;25/02/2021;202104;60;PROD
11901101;1604213675;925;1190;265;25/02/2021;202104;60;DOM
11901102;82449509;981;1076;95;25/02/2021;202104;60;DOM
11901103;141826420;2711;2825;114;25/02/2021;202104;60;DOM
11901104;11901104-int;776;812;36;25/02/2021;202104;60;DOM
11901106;14225393785;18488;19349;861;25/02/2021;202104;60;PROD
11901107;82449331;1428;1573;145;25/02/2021;202104;60;DOM
11901108;11901108-int;253;313;60;25/02/2021;202104;60;DOM
11901109;5809;647;700;53;25/02/2021;202104;60;DOM
11901110;5707;2515;2643;128;25/02/2021;202104;60;DOM
11901111;1604214812;795;858;63;25/02/2021;202104;60;DOM
11901112;141826418;1870;1924;54;25/02/2021;202104;60;DOM
11901113;1604213303;2968;3005;37;25/02/2021;202104;60;DOM
11901114;141826421;2365;2606;241;25/02/2021;202104;60;DOM
11901115;1441826422;2640;2783;143;25/02/2021;202104;60;DOM
11901116;4829;2045;2174;129;25/02/2021;202104;60;DOM
11901117;1604214658;758;792;34;25/02/2021;202104;60;DOM
11901118;141826419;1335;1456;121;25/02/2021;202104;60;DOM
11901119;141826423;1398;1484;86;25/02/2021;202104;60;DOM
11901120;2,02E+11;3960;4265;305;25/02/2021;202104;60;DOM
11901121;2,02E+11;1753;1918;165;25/02/2021;202104;60;DOM
11901122;2,02E+11;2200;2392;192;25/02/2021;202104;60;DOM
11901123;2,02E+11;1734;2010;276;25/02/2021;202104;60;DOM
11901124;2,02E+11;0;0;36;25/02/2021;202104;60;DOM
11901125;2,02E+11;2261;2428;167;25/02/2021;202104;60;DOM
11901126;2,02E+11;1433;1913;480;25/02/2021;202104;60;DOM
11901127;2,02E+11;1172;1352;180;25/02/2021;202104;60;DOM
11901128;2,02E+11;209;246;37;25/02/2021;202104;60;DOM
11901130;2,02E+11;1542;1563;21;25/02/2021;202104;60;DOM
11901132;2,02E+11;1090;1415;325;25/02/2021;202104;60;DOM
11901133;2,02E+11;295;311;16;25/02/2021;202104;60;DOM
11901134;2,02E+11;1413;1525;112;25/02/2021;202104;60;PROD
11901135;2,02E+11;2629;2659;30;25/02/2021;202104;60;PROD
11901136;82448968;156;193;37;25/02/2021;202104;60;DOM
11901137;2,02E+11;1198;1228;30;25/02/2021;202104;60;DOM
11901138;2,02E+11;5090;5269;179;25/02/2021;202104;60;DOM
11901139;82369036;1563;1638;75;25/02/2021;202104;60;DOM
11901140;82368325;1528;1722;194;25/02/2021;202104;60;PROD
11901141;82368420;150;169;19;25/02/2021;202104;60;DOM
11901142;82368625;425;476;51;25/02/2021;202104;60;DOM
11901143;82368637;3502;3850;348;25/02/2021;202104;60;DOM
11901144;82368571;96;105;9;25/02/2021;202104;60;DOM
11901145;82368867;4293;4499;206;25/02/2021;202104;60;DOM
11901147;82368596;147;161;14;25/02/2021;202104;60;DOM
11901148;82449979;583;715;132;25/02/2021;202104;60;DOM
11901149;82368553;160;178;18;25/02/2021;202104;60;DOM
11901150;82368961;1398;1398;0;25/02/2021;202104;60;DOM
11901151;82368819;517;559;42;25/02/2021;202104;60;DOM
11901152;82450244;230;258;28;25/02/2021;202104;60;DOM
11901153;82369072;69;79;10;25/02/2021;202104;60;DOM
11901154;82369024;1865;2015;150;25/02/2021;202104;60;DOM
11901155;82459050;410;506;96;25/02/2021;202104;60;DOM
11901156;82450347;264;312;48;25/02/2021;202104;60;DOM
11901157;82368885;1199;1213;14;25/02/2021;202104;60;DOM
11901158;82369067;217;220;3;25/02/2021;202104;60;PROD
11901159;82450377;1080;1190;110;25/02/2021;202104;60;DOM
11901160;82450374;256;292;36;25/02/2021;202104;60;DOM
11901161;82450252;269;308;39;25/02/2021;202104;60;DOM
11901162;82450344;929;999;70;25/02/2021;202104;60;DOM
11901163;82449415;298;340;42;25/02/2021;202104;60;DOM
11901164;82368513;312;334;22;25/02/2021;202104;60;DOM
11901165;37219569169;0;93;93;25/02/2021;202104;60;DOM
11901166;11901166-int;15;21;6;25/02/2021;202104;60;DOM
11901167;41235940;1134;1246;112;25/02/2021;202104;60;PROD
11901168;41235749;1682;1742;60;25/02/2021;202104;60;PROD
11901169;82368628;128;139;11;25/02/2021;202104;60;DOM
11901170;82368529;766;810;44;25/02/2021;202104;60;PROD
11901171;82369011;138;148;10;25/02/2021;202104;60;DOM
11901172;37219579382;170;189;19;25/02/2021;202104;60;DOM
11901173;82450335;72;83;11;25/02/2021;202104;60;DOM
11901174;82368631;142;175;33;25/02/2021;202104;60;DOM
11901175;82368555;275;372;97;25/02/2021;202104;60;DOM
11901176;2016-07098503;1783;1920;137;25/02/2021;202104;60;DOM
11901177;82368543;2430;2517;87;25/02/2021;202104;60;DOM
11901178;82450403;524;657;133;25/02/2021;202104;60;DOM
11901179;82449494;526;592;66;25/02/2021;202104;60;DOM
11901181;41235843;11842;12865;1023;25/02/2021;202104;60;PROD
11901182;41235954;2150;2447;297;25/02/2021;202104;60;PROD
11901184;41290074;6128;6328;200;25/02/2021;202104;60;PROD
11901185;82450116;1070;1530;460;25/02/2021;202104;60;DOM
11901186;82449737;326;337;11;25/02/2021;202104;60;DOM
11901187;41235727;43091;46531;3440;25/02/2021;202104;60;PROD
11901188;82449611;597;637;40;25/02/2021;202104;60;DOM
11901189;82450334;1237;1366;129;25/02/2021;202104;60;DOM
11901190;82449788;106;121;15;25/02/2021;202104;60;DOM
11901191;41235742;12982;14566;1584;25/02/2021;202104;60;PROD
11901193;82450463;95;111;16;25/02/2021;202104;60;DOM
11901194;82449363;362;409;47;25/02/2021;202104;60;DOM
11901195;37219578780;127;275;148;25/02/2021;202104;60;DOM
11901196;82450359;2359;2629;270;25/02/2021;202104;60;DOM
11901198;82450428;1515;1680;165;25/02/2021;202104;60;DOM
11901199;82450315;213;236;23;25/02/2021;202104;60;DOM
11901200;82450029;788;797;9;25/02/2021;202104;60;DOM
11901201;82450412;189;202;13;25/02/2021;202104;60;DOM
11901202;82449842;396;413;17;25/02/2021;202104;60;DOM
11901203;82450371;56;62;6;25/02/2021;202104;60;DOM
11901204;82449888;365;365;0;25/02/2021;202104;60;DOM
11901205;82450612;33;46;13;25/02/2021;202104;60;DOM
11901206;82450441;1426;1674;248;25/02/2021;202104;60;DOM
11901207;82450414;726;817;91;25/02/2021;202104;60;DOM
11901208;82450464;301;435;134;25/02/2021;202104;60;DOM
11901209;37219579259;500;587;87;25/02/2021;202104;60;DOM
11901210;82449391;92;93;1;25/02/2021;202104;60;DOM
11901211;82449767;37;42;5;25/02/2021;202104;60;DOM
11901212;82450572;966;1033;67;25/02/2021;202104;60;PROD
11901213;82450898;666;794;128;25/02/2021;202104;60;DOM
11901214;37219579507;805;911;106;25/02/2021;202104;60;DOM
11901215;82450465;24;28;4;25/02/2021;202104;60;DOM
11901216;82449525;200;246;46;25/02/2021;202104;60;DOM
11901217;37219579408;140;172;32;25/02/2021;202104;60;DOM
11901219;82449687;106;130;24;25/02/2021;202104;60;DOM
11901220;37219579374;1083;1220;137;25/02/2021;202104;60;DOM
11901221;82450175;404;579;175;25/02/2021;202104;60;PROD
11901222;37219579317;435;494;59;25/02/2021;202104;60;PROD
11901223;82450305;157;179;22;25/02/2021;202104;60;DOM
11901224;37219579325;100;124;24;25/02/2021;202104;60;DOM
11901226;82449728;39;46;7;25/02/2021;202104;60;DOM
11901227;82449902;105;138;33;25/02/2021;202104;60;DOM
11901228;37219579440;362;416;54;25/02/2021;202104;60;DOM
11901229;37219572221;414;616;202;25/02/2021;202104;60;DOM
11901230;37219579267;127;155;28;25/02/2021;202104;60;DOM
11901231;37219579481;75;88;13;25/02/2021;202104;60;DOM
11901232;37219579358;845;846;1;25/02/2021;202104;60;DOM
11901233;37219579499;1014;1019;5;25/02/2021;202104;60;DOM
11901234;37219579424;591;680;89;25/02/2021;202104;60;DOM
11901235;37219570803;32;53;21;25/02/2021;202104;60;DOM
11901236;37219572544;0;133;133;25/02/2021;202104;60;DOM
11901237;82449893;110;128;18;25/02/2021;202104;60;DOM
11901241;37219578103;64;88;24;25/02/2021;202104;60;DOM
11901242;37219569409;0;0;0;25/02/2021;202104;60;DOM
11901243;37219578772;8;10;2;25/02/2021;202104;60;DOM
11901244;37219577121;91;109;18;25/02/2021;202104;60;DOM
11901245;37219572569;917;1083;166;25/02/2021;202104;60;DOM
11901246;37219578756;554;687;133;25/02/2021;202104;60;DOM
11901247;37219571413;22;31;9;25/02/2021;202104;60;DOM
11901248;37219567767;45;58;13;25/02/2021;202104;60;DOM
11901249;37219570886;26;35;9;25/02/2021;202104;60;DOM
11901251;37219569169;0;98;98;25/02/2021;202104;60;PROD
11901256;37219569003;0;51;51;25/02/2021;202104;60;DOM
11901258;37219569367;0;19;19;25/02/2021;202104;60;PROD
22301001;170809-0026;5449;5633;184;25/02/2021;202104;60;DOM
22301003;150303-0379;6178;6280;102;25/02/2021;202104;60;PROD
22301004;22301004-int;156;256;100;25/02/2021;202104;60;DOM
22301006;22301006-int;696;733;37;25/02/2021;202104;60;DOM
22301008;150303-0394;12658;13094;436;25/02/2021;202104;60;DOM
22301009;22301009-int;232;256;24;25/02/2021;202104;60;DOM
22301011;22301011-int;228;276;48;25/02/2021;202104;60;DOM
22301012;150303-0330;10454;10755;301;25/02/2021;202104;60;DOM
22301013;150303-0410;7090;7353;263;25/02/2021;202104;60;DOM
22301016;150303-0486;5980;6311;331;25/02/2021;202104;60;DOM
22301017;150303-0022;6155;6372;217;25/02/2021;202104;60;DOM
22301018;22301018-int;87;113;26;25/02/2021;202104;60;DOM
22301019;150303-0325;11273;11711;438;25/02/2021;202104;60;DOM
22301025;22301025-int;232;248;16;25/02/2021;202104;60;DOM
22301028;22301028-int;772;795;23;25/02/2021;202104;60;DOM
22301031;22301031-int;342;359;17;25/02/2021;202104;60;DOM
22301032;22301032-int;325;349;24;25/02/2021;202104;60;DOM
22301035;22301035-int;91;122;31;25/02/2021;202104;60;DOM
22301046;22301046-int;983;1098;115;25/02/2021;202104;60;DOM
22301047;150303-0416;4494;4585;91;25/02/2021;202104;60;DOM
22301051;37219562818-7;21;36;15;25/02/2021;202104;60;DOM
22301056;150303-0252;6496;6550;54;25/02/2021;202104;60;DOM
22301057;150303-0250;8633;8813;180;25/02/2021;202104;60;DOM
22301058;150303-0249;8522;8709;187;25/02/2021;202104;60;DOM
22301061;150303-0455;7955;8035;80;25/02/2021;202104;60;DOM
22301065;22301065-int;138;151;13;25/02/2021;202104;60;DOM
22301068;150303-0021;9279;9447;168;25/02/2021;202104;60;DOM
22301072;150303-0259;1096;1260;164;25/02/2021;202104;60;DOM
22301073;22301073-int;49;73;24;25/02/2021;202104;60;DOM
22301075;22301075-int;193021;194867;1846;25/02/2021;202104;60;PROD
22301076;150303-0030;6583;6742;159;25/02/2021;202104;60;DOM
22301077;150303-0260;6300;6408;108;25/02/2021;202104;60;DOM
22301078;22301078-int;23650;23693;43;25/02/2021;202104;60;PROD
22301079;150303-0238;3886;4054;168;25/02/2021;202104;60;PROD
22301081;150303-0023;4701;4915;214;25/02/2021;202104;60;DOM
22301083;150303-0380;6875;7032;157;25/02/2021;202104;60;PROD
22301084;150303-0351;7077;7099;22;25/02/2021;202104;60;DOM
22301086;150303-0392;8324;8324;0;25/02/2021;202104;60;DOM
22301087;150303-0377;11077;11615;538;25/02/2021;202104;60;DOM
22301089;22301089-int;34625;42004;7379;25/02/2021;202104;60;PROD
22301094;150303-0291;7220;7497;277;25/02/2021;202104;60;DOM
22301096;22301096-int;9523;9994;471;25/02/2021;202104;60;PROD
22301097;150303-0432;2355;2442;87;25/02/2021;202104;60;DOM
22301099;150303-0024;3013;3024;11;25/02/2021;202104;60;DOM
22301106;150303-0468;1699;1699;0;25/02/2021;202104;60;DOM
22301115;22301115-int;189;213;24;25/02/2021;202104;60;DOM
22301116;150303-0158;737;770;33;25/02/2021;202104;60;DOM
22301118;150303-0500;1966;2009;43;25/02/2021;202104;60;DOM
22301119;150303-0097;2559;2934;375;25/02/2021;202104;60;DOM
22301120;150303-0099;2827;3115;288;25/02/2021;202104;60;DOM
22301121;22301121-int;5125;5578;453;25/02/2021;202104;60;PROD
22301132;22301132-int;176;188;12;25/02/2021;202104;60;DOM
22301142;150303-0123;7473;7831;358;25/02/2021;202104;60;DOM
22301143;170306-0003;2954;3036;82;25/02/2021;202104;60;PROD
22301144;150303-0124;1989;2040;51;25/02/2021;202104;60;DOM
22301177;170809-0218;824;886;62;25/02/2021;202104;60;PROD
22301178;170809-0236;959;1002;43;25/02/2021;202104;60;PROD
22301179;22301179-int;627;682;55;25/02/2021;202104;60;DOM
22301180;22301180-int;4947;5982;1035;25/02/2021;202104;60;PROD
22301182;22301182-int;1637;1899;262;25/02/2021;202104;60;DOM
22301184;22301184-int;1658;1658;0;25/02/2021;202104;60;PROD
22301185;22301185-int;98;238;140;25/02/2021;202104;60;DOM
22301186;22301186-int;229;311;82;25/02/2021;202104;60;DOM
22301187;22301187-int;173;200;27;25/02/2021;202104;60;DOM
22301188;22301188-int;102;130;28;25/02/2021;202104;60;DOM
22301189;22301189-int;70;82;12;25/02/2021;202104;60;DOM
22301195;22301195-int;132;157;25;25/02/2021;202104;60;DOM
22301196;22301196-int;339;391;52;25/02/2021;202104;60;DOM
22301198;22301198-int;48;67;19;25/02/2021;202104;60;DOM
22301200;22301200-int;50;65;15;25/02/2021;202104;60;DOM
22301201;22301201-int;609;653;44;25/02/2021;202104;60;DOM
22301202;22301202-int;142;196;54;25/02/2021;202104;60;DOM
22301203;22301203-int;48;75;27;25/02/2021;202104;60;DOM
22301204;22301204-int;1915;1915;0;25/02/2021;202104;60;PROD
22301205;22301205-int;118;141;23;25/02/2021;202104;60;DOM
22301206;22301206-int;1250;1397;147;25/02/2021;202104;60;DOM
22301207;22301207-int;154;188;34;25/02/2021;202104;60;DOM
22301209;22301209-int;257;308;51;25/02/2021;202104;60;DOM
22301210;22301210-int;67;106;39;25/02/2021;202104;60;PROD
22301211;22301211-int;86;120;34;25/02/2021;202104;60;DOM
22301212;22301212-int;778;852;74;25/02/2021;202104;60;DOM
22301214;22301214-int;603;682;79;25/02/2021;202104;60;DOM
22301216;3461;19635;19635;0;25/02/2021;202104;60;PROD
22301218;37219578996-3;297;297;0;25/02/2021;202104;60;DOM
22302001;150303-0456;6152;6175;23;25/02/2021;202104;60;DOM
22302003;37219562800-5;225;408;183;25/02/2021;202104;60;DOM
22302008;150303-0378;1296;1353;57;25/02/2021;202104;60;DOM
22302017;150303-0112;748;774;26;25/02/2021;202104;60;DOM
22302023;170809-0111;5111;5121;10;25/02/2021;202104;60;DOM
22302024;22302024-int;75;114;39;25/02/2021;202104;60;DOM
22302027;22302027-int;512;530;18;25/02/2021;202104;60;DOM
22302029;22302029-int;174;195;21;25/02/2021;202104;60;DOM
22303026;22303026-int;7550;7625;75;25/02/2021;202104;60;DOM
22303035;22303035-int;134;148;14;25/02/2021;202104;60;DOM
22303037;22303037-int;956;1114;158;25/02/2021;202104;60;DOM
22303038;22303038-int;86;91;5;25/02/2021;202104;60;DOM
22304006;22304006-int;603;730;127;25/02/2021;202104;60;DOM
22304011;150303-0284;8832;9163;331;25/02/2021;202104;60;DOM
22304013;150303-0312;9676;9991;315;25/02/2021;202104;60;DOM
22308001;170809-0268;2333;2410;77;25/02/2021;202104;60;DOM
22308002;22308002-int;1331;1446;115;25/02/2021;202104;60;DOM
22308003;170809-0267;6585;6762;177;25/02/2021;202104;60;DOM
22308004;170809-0334;2466;2716;250;25/02/2021;202104;60;DOM
22308005;22308005-int;81;94;13;25/02/2021;202104;60;DOM
22308006;170809-0269;3138;3283;145;25/02/2021;202104;60;DOM
22308008;22308008-int;13120;13200;80;25/02/2021;202104;60;PROD
22308009;22308009-int;2521;2521;0;25/02/2021;202104;60;PROD
22308010;22308010-int;79812;97391;17579;25/02/2021;202104;60;PROD
22308011;22308011-int;2105;2276;171;25/02/2021;202104;60;PROD
22308012;22308012-int;18925;19014;89;25/02/2021;202104;60;PROD
22308014;22308014-int;11250;11479;229;25/02/2021;202104;60;PROD
22308015;170809-0073;2937;2951;14;25/02/2021;202104;60;DOM
22308016;170809-0153;3715;3797;82;25/02/2021;202104;60;DOM
22308017;170809-0169;139;170;31;25/02/2021;202104;60;DOM
22308018;22308018-int;567;671;104;25/02/2021;202104;60;DOM
22308019;170809-0182;4797;5077;280;25/02/2021;202104;60;DOM
22308020;170809-0098;6008;6017;9;25/02/2021;202104;60;DOM
22308021;170809-0154;769;813;44;25/02/2021;202104;60;DOM
22308022;170809-0198;1744;1761;17;25/02/2021;202104;60;DOM
22308023;22308023-int;18124;18206;82;25/02/2021;202104;60;PROD
22308024;22308024-int;565;565;0;25/02/2021;202104;60;DOM
22308025;170809-0046;3624;3794;170;25/02/2021;202104;60;DOM
22308026;170809-0044;3299;3398;99;25/02/2021;202104;60;DOM
22308027;170809-0196;2138;2151;13;25/02/2021;202104;60;DOM
22308028;170809-0276;4263;4306;43;25/02/2021;202104;60;PROD
22308029;170809-0316;2138;2253;115;25/02/2021;202104;60;DOM
22308031;22308031-int;2032;2136;104;25/02/2021;202104;60;DOM
22308032;170809-0181;1190;1383;193;25/02/2021;202104;60;DOM
22308034;170809-0179;2500;2583;83;25/02/2021;202104;60;DOM
22308035;170809-0315;4259;4545;286;25/02/2021;202104;60;DOM
22308036;170809-0275;4949;5283;334;25/02/2021;202104;60;PROD
22308037;22308037-int;8247;8666;419;25/02/2021;202104;60;PROD
22308038;170809-0097;1486;1544;58;25/02/2021;202104;60;DOM
22308039;170809-0167;3927;4112;185;25/02/2021;202104;60;DOM
22308040;170809-0095;4314;4485;171;25/02/2021;202104;60;DOM
22308041;170809-0277;2280;2408;128;25/02/2021;202104;60;DOM
22308042;170809-0072;2092;2180;88;25/02/2021;202104;60;DOM
22308043;170809-0333;4133;4343;210;25/02/2021;202104;60;DOM
22308044;170809-0332;2831;2993;162;25/02/2021;202104;60;DOM
22308045;170809-0168;1824;1860;36;25/02/2021;202104;60;PROD
22308046;170809-0071;2606;2680;74;25/02/2021;202104;60;DOM
22308047;170809-0151;4497;5019;522;25/02/2021;202104;60;DOM
22308048;170809-0096;2845;2855;10;25/02/2021;202104;60;DOM
22308049;170809-0331;3897;4160;263;25/02/2021;202104;60;DOM
22308050;170809-0195;2401;2418;17;25/02/2021;202104;60;PROD
22308051;170809-0270;2639;2791;152;25/02/2021;202104;60;PROD
22308052;170809-0180;1313;1434;121;25/02/2021;202104;60;DOM
22308053;170809-0197;1180;1351;171;25/02/2021;202104;60;DOM
22308054;170809-0317;2201;2289;88;25/02/2021;202104;60;PROD
22308055;22308055-int;4211;4250;39;25/02/2021;202104;60;PROD
22308056;170809-0074;4050;4294;244;25/02/2021;202104;60;DOM
22308057;170809-0043;547;561;14;25/02/2021;202104;60;DOM
22308058;22308058-int;4925;5248;323;25/02/2021;202104;60;PROD
22308061;22308061-int;2576;2782;206;25/02/2021;202104;60;DOM
22308062;170809-0045;3446;3577;131;25/02/2021;202104;60;DOM
22308063;22308063-int;282;312;30;25/02/2021;202104;60;DOM
22308064;150303-0313;7220;8006;786;25/02/2021;202104;60;DOM
22308065;22308065-int;3155;3412;257;25/02/2021;202104;60;DOM
22308066;22308066-int;937;972;35;25/02/2021;202104;60;DOM
22308067;22308067-int;954;1177;223;25/02/2021;202104;60;DOM
22308068;22308068-int;1115;1162;47;25/02/2021;202104;60;DOM
22308069;22308069-int;523;523;0;25/02/2021;202104;60;PROD
22308070;22308070-int;6054;6398;344;25/02/2021;202104;60;PROD
22308073;14250526689;2619;2752;133;25/02/2021;202104;60;DOM
22308074;14250516888;3076;3242;166;25/02/2021;202104;60;DOM
22308075;22308075-int;7060;7627;567;25/02/2021;202104;60;DOM
22308076;170809-0184;2073;2355;282;25/02/2021;202104;60;DOM
22308077;22308077-int;4702;4746;44;25/02/2021;202104;60;PROD
22308078;14250494359;1352;1382;30;25/02/2021;202104;60;PROD
22308079;22308079-int;3539;3989;450;25/02/2021;202104;60;DOM
22308080;22308080-int;13523;13664;141;25/02/2021;202104;60;PROD
22308081;22308081-int;3551;3838;287;25/02/2021;202104;60;DOM
22308082;22308082-int;1782;1844;62;25/02/2021;202104;60;PROD
22308083;22308083-int;2151;2332;181;25/02/2021;202104;60;DOM
22308084;22308084-int;2419;2657;238;25/02/2021;202104;60;DOM
22308085;22308085-int;1180;1180;0;25/02/2021;202104;60;DOM
22308086;22308086-int;43;50;7;25/02/2021;202104;60;DOM
22308087;22308087-int;2353;2549;196;25/02/2021;202104;60;DOM
22308088;22308088-int;951;961;10;25/02/2021;202104;60;DOM
22308089;22308089-int;2042;2292;250;25/02/2021;202104;60;DOM
22308090;22308090-int;2065;2178;113;25/02/2021;202104;60;DOM
22308091;22308091-int;2980;3195;215;25/02/2021;202104;60;DOM
22308092;22308092-int;2766;2815;49;25/02/2021;202104;60;DOM
22308093;22308093-int;2486;2796;310;25/02/2021;202104;60;DOM
22308094;22308094-int;1915;1985;70;25/02/2021;202104;60;DOM
22308095;22308095-int;1455;1716;261;25/02/2021;202104;60;DOM
22308096;22308096-int;1622;1830;208;25/02/2021;202104;60;DOM
22308097;22308097-int;392;411;19;25/02/2021;202104;60;DOM
22308098;22308098-int;438;491;53;25/02/2021;202104;60;DOM
22308099;22308099-int;291;337;46;25/02/2021;202104;60;DOM
22308100;22308100-int;623;683;60;25/02/2021;202104;60;DOM
22308101;22308101-int;1038;1263;225;25/02/2021;202104;60;DOM
22308102;22308102-int;129;153;24;25/02/2021;202104;60;DOM
22308103;22308103-int;179;203;24;25/02/2021;202104;60;DOM
22308105;22308105-int;203;225;22;25/02/2021;202104;60;DOM
22308106;22308106-int;1978;2182;204;25/02/2021;202104;60;DOM
22308107;22308107-int;834;930;96;25/02/2021;202104;60;DOM
22308108;22308108-int;254;303;49;25/02/2021;202104;60;DOM
22308109;22308109-int;71;79;8;25/02/2021;202104;60;DOM
22308110;22308110-int;831;952;121;25/02/2021;202104;60;DOM
22308111;22308111-int;105;120;15;25/02/2021;202104;60;DOM
22308112;22308112-int;193;236;43;25/02/2021;202104;60;DOM
22308113;22308113-int;234;262;28;25/02/2021;202104;60;DOM
22308115;22308115-int;473;551;78;25/02/2021;202104;60;DOM
22308116;22308116-int;760;782;22;25/02/2021;202104;60;DOM
22308117;22308117-int;268;314;46;25/02/2021;202104;60;DOM
22308118;22308118-int;999;1071;72;25/02/2021;202104;60;DOM
22308119;37219563162-9;15;15;0;25/02/2021;202104;60;DOM
22308120;22308120-int;73;85;12;25/02/2021;202104;60;DOM
22308122;22308122-int;226;248;22;25/02/2021;202104;60;DOM
22308123;22308123-int;27;32;5;25/02/2021;202104;60;DOM
22308124;22308124-int;152;164;12;25/02/2021;202104;60;DOM
22308125;22308125-int;385;588;203;25/02/2021;202104;60;DOM
22308126;22308126-int;233;260;27;25/02/2021;202104;60;DOM
22308127;22308127-int;63;69;6;25/02/2021;202104;60;DOM
22308128;22308128-int;227;267;40;25/02/2021;202104;60;DOM
22308129;22308129-int;1449;1562;113;25/02/2021;202104;60;DOM
22308130;22308130-int;302;336;34;25/02/2021;202104;60;DOM
22308131;22308131-int;1619;1745;126;25/02/2021;202104;60;DOM
22308134;22308134-int;265;301;36;25/02/2021;202104;60;DOM
22308135;22308135-int;875;895;20;25/02/2021;202104;60;DOM
22308136;22308136-int;218;253;35;25/02/2021;202104;60;DOM
22308137;22308137-int;131;157;26;25/02/2021;202104;60;DOM
22308138;37219563105-3;52;87;35;25/02/2021;202104;60;DOM
22308139;22308139-int;262;301;39;25/02/2021;202104;60;DOM
22308140;22308140-int;527;574;47;25/02/2021;202104;60;DOM
22308141;22308141-int;260;298;38;25/02/2021;202104;60;DOM
22308143;22308143-int;329;366;37;25/02/2021;202104;60;DOM
22308145;22308145-int;213;230;17;25/02/2021;202104;60;DOM
22308146;22308146-int;705;705;0;25/02/2021;202104;60;DOM
22308149;22308149-int;1113;1212;99;25/02/2021;202104;60;DOM
22308150;22308150-int;163;185;22;25/02/2021;202104;60;DOM
22308153;22308153-int;95;106;11;25/02/2021;202104;60;DOM
22308154;22308154-int;995;995;0;25/02/2021;202104;60;DOM
22308155;22308155-int;108;120;12;25/02/2021;202104;60;DOM
22308156;22308156-int;682;715;33;25/02/2021;202104;60;DOM
22308157;22308157-int;0;0;0;25/02/2021;202104;60;DOM
22308158;22308158-int;1892;2083;191;25/02/2021;202104;60;DOM
22308159;22308159-int;122;130;8;25/02/2021;202104;60;DOM
22308160;22308160-int;656;700;44;25/02/2021;202104;60;DOM
22308161;22308161-int;143;176;33;25/02/2021;202104;60;DOM
22308162;22308162-int;230;262;32;25/02/2021;202104;60;DOM
22308163;22308163-int;88;136;48;25/02/2021;202104;60;DOM
22308164;22308164-int;224;270;46;25/02/2021;202104;60;DOM
22308165;22308165-int;692;801;109;25/02/2021;202104;60;DOM
22308166;22308166-int;340;378;38;25/02/2021;202104;60;DOM
22308167;22308167-int;0;150;150;25/02/2021;202104;60;DOM
22308168;22308168-int;237;284;47;25/02/2021;202104;60;DOM
22308169;22308169-int;120;138;18;25/02/2021;202104;60;DOM
22308170;22308170-int;1330;1453;123;25/02/2021;202104;60;PROD
22308171;22308171-int;449;489;40;25/02/2021;202104;60;DOM
22308174;22308174-int;340;340;0;25/02/2021;202104;60;DOM
22308175;22308175-int;77;83;6;25/02/2021;202104;60;DOM
22308176;22308176-int;521;537;16;25/02/2021;202104;60;PROD
22308177;22308177-int;269;311;42;25/02/2021;202104;60;DOM
22308178;22308178-int;229;266;37;25/02/2021;202104;60;DOM
22308180;22308180-int;90;114;24;25/02/2021;202104;60;DOM
22308181;22308181-int;709;926;217;25/02/2021;202104;60;DOM
22308182;22308182-int;187;229;42;25/02/2021;202104;60;DOM
22308184;22308184-int;148;189;41;25/02/2021;202104;60;DOM
22308185;22308185-int;1105;1118;13;25/02/2021;202104;60;PROD
22308186;22308186-int;6;6;0;25/02/2021;202104;60;DOM
22308187;22308187-int;344;494;150;25/02/2021;202104;60;DOM
22308188;22308188-int;128;217;89;25/02/2021;202104;60;DOM
22308189;22308189-int;141;182;41;25/02/2021;202104;60;DOM
22308190;22308190-int;421;484;63;25/02/2021;202104;60;DOM
22308191;22308191-int;129;151;22;25/02/2021;202104;60;DOM
22308192;22308192-int;174;204;30;25/02/2021;202104;60;DOM
22308193;22308193-int;448;506;58;25/02/2021;202104;60;DOM
22308194;22308194-int;511;598;87;25/02/2021;202104;60;DOM
22308195;22308195-int;177;198;21;25/02/2021;202104;60;DOM
22308196;22308196-int;2105;2260;155;25/02/2021;202104;60;PROD
22308197;22308197-int;325;419;94;25/02/2021;202104;60;PROD
22308198;22308198-int;49;60;11;25/02/2021;202104;60;DOM
22308199;22308199-int;122;212;90;25/02/2021;202104;60;DOM
22308200;22308200-int;815;840;25;25/02/2021;202104;60;DOM
22308201;22308201-int;191;243;52;25/02/2021;202104;60;DOM
22308202;22308202-int;147;183;36;25/02/2021;202104;60;DOM
22308203;22308203-int;169;176;7;25/02/2021;202104;60;DOM
22308204;22308204-int;207;236;29;25/02/2021;202104;60;DOM
22308205;22308205-int;2147;2729;582;25/02/2021;202104;60;DOM
22308206;22308206-int;783;809;26;25/02/2021;202104;60;DOM
22308207;22308207-int;1702;2053;351;25/02/2021;202104;60;PROD
22308208;22308208-int;159;193;34;25/02/2021;202104;60;DOM
22308209;22308209-int;120;214;94;25/02/2021;202104;60;DOM
22308210;22308210-int;140;176;36;25/02/2021;202104;60;DOM
22308211;22308211-int;37;60;23;25/02/2021;202104;60;DOM
22308212;22308212-int;588;695;107;25/02/2021;202104;60;DOM
22308213;22308213-int;50;65;15;25/02/2021;202104;60;DOM
22308214;22308214-int;649;698;49;25/02/2021;202104;60;DOM
22308215;22308215-int;112;146;34;25/02/2021;202104;60;DOM
22308216;22308216-int;179;251;72;25/02/2021;202104;60;DOM
22308217;37219562834-4;27;45;18;25/02/2021;202104;60;DOM
22308218;22308218-int;54;72;18;25/02/2021;202104;60;DOM
22308219;37219572957-1;24;28;4;25/02/2021;202104;60;DOM
22308220;22308220-int;177;223;46;25/02/2021;202104;60;DOM
22308221;22308221-int;14;14;0;25/02/2021;202104;60;DOM
22308222;22308222-int;197;257;60;25/02/2021;202104;60;DOM
22308223;22308223-int;10;12;2;25/02/2021;202104;60;DOM
22308224;22308224-int;82;102;20;25/02/2021;202104;60;DOM
22308225;22308225-int;200;303;103;25/02/2021;202104;60;DOM
22308226;22308226-int;105;126;21;25/02/2021;202104;60;DOM
22308227;22308227-int;18;23;5;25/02/2021;202104;60;DOM
22308228;22308228-int;50;75;25;25/02/2021;202104;60;DOM
22308229;22308229-int;146;170;24;25/02/2021;202104;60;DOM
22308230;22308230-int;63;75;12;25/02/2021;202104;60;DOM
22308232;22308232-int;491;689;198;25/02/2021;202104;60;DOM
22308233;37219567692-1;48;48;0;25/02/2021;202104;60;PROD
22308234;22308234-int;392;484;92;25/02/2021;202104;60;DOM
22308235;22308235-int;202;260;58;25/02/2021;202104;60;DOM
22308236;70002940230;0;123;123;25/02/2021;202104;60;PROD
22308237;37219572084-6;45;65;20;25/02/2021;202104;60;DOM
22308238;37219572973-8;17;23;6;25/02/2021;202104;60;DOM
22308239;37219565928-1;122;314;192;25/02/2021;202104;60;DOM
22308240;37219582849-4;25;30;5;25/02/2021;202104;60;DOM
22308241;37219572999-3;24;38;14;25/02/2021;202104;60;DOM
22308242;37219563702-5;27;35;8;25/02/2021;202104;60;DOM
22308244;37219575463-7;70;93;23;25/02/2021;202104;60;DOM
22308248;37219572940-7;87;114;27;25/02/2021;202104;60;DOM
22308250;70002940644;0;50;50;25/02/2021;202104;60;PROD
22324001;22324001-int;9285;10009;724;25/02/2021;202104;60;PROD
22324002;22324002-int;4585;5095;510;25/02/2021;202104;60;DOM
22324003;22324003-int;257;284;27;25/02/2021;202104;60;DOM
22324004;22324004-int;1076;1205;129;25/02/2021;202104;60;DOM
22324005;22324005-int;777;902;125;25/02/2021;202104;60;DOM
22324006;22324006-int;62514;67089;4575;25/02/2021;202104;60;PROD
22324007;22324007-int;480;518;38;25/02/2021;202104;60;DOM
22324008;22324008-int;199;234;35;25/02/2021;202104;60;DOM
22324010;22324010-int;409;443;34;25/02/2021;202104;60;DOM
22324011;22324011-int;1234;1458;224;25/02/2021;202104;60;DOM
22324012;22324012-int;181;181;0;25/02/2021;202104;60;DOM
22324013;22324013-int;1059;1140;81;25/02/2021;202104;60;DOM
22324014;22324014-int;1113;1199;86;25/02/2021;202104;60;DOM
22324015;22324015-int;286;319;33;25/02/2021;202104;60;DOM
22324016;22324016-int;1016;1151;135;25/02/2021;202104;60;DOM
22324017;22324017-int;51;59;8;25/02/2021;202104;60;DOM
22324018;22324018-int;624;737;113;25/02/2021;202104;60;DOM
22324019;22324019-int;7514;8702;1188;25/02/2021;202104;60;PROD
22324020;22324020-int;1109;1152;43;25/02/2021;202104;60;DOM
22324021;22324021-int;400;457;57;25/02/2021;202104;60;DOM
22324022;22324022-int;751;862;111;25/02/2021;202104;60;DOM
22324023;22324023-int;1599;1854;255;25/02/2021;202104;60;DOM
22324025;22324025-int;371;415;44;25/02/2021;202104;60;DOM
22324026;22324026-int;924;1257;333;25/02/2021;202104;60;DOM
22324028;22324028-int;762;886;124;25/02/2021;202104;60;DOM
22324029;22324029-int;1027;1176;149;25/02/2021;202104;60;DOM
22324030;22324030-int;695;751;56;25/02/2021;202104;60;DOM
22324031;22324031-int;59;67;8;25/02/2021;202104;60;DOM
22324032;22324032-int;57;68;11;25/02/2021;202104;60;DOM
22324033;22324033-int;543;717;174;25/02/2021;202104;60;DOM
22324034;22324034-int;1300;1414;114;25/02/2021;202104;60;DOM
22324035;22324035-int;262;372;110;25/02/2021;202104;60;DOM
22324036;22324036-int;240;276;36;25/02/2021;202104;60;DOM
22324037;22324037-int;294;366;72;25/02/2021;202104;60;DOM
22324038;22324038-int;419;501;82;25/02/2021;202104;60;DOM
22324039;22324039-int;903;1135;232;25/02/2021;202104;60;DOM
22324040;22324040-int;0;0;0;25/02/2021;202104;60;DOM
22324041;22324041-int;242;280;38;25/02/2021;202104;60;DOM
22324043;22324043-int;211;255;44;25/02/2021;202104;60;DOM
22324044;22324044-int;1697;1760;63;25/02/2021;202104;60;DOM
22324045;22324045-int;1267;1529;262;25/02/2021;202104;60;DOM
22324046;22324046-int;1652;1818;166;25/02/2021;202104;60;DOM
22324048;22324048-int;69;90;21;25/02/2021;202104;60;DOM
22324049;22324049-int;160;203;43;25/02/2021;202104;60;DOM
22324050;22324050-int;179;222;43;25/02/2021;202104;60;DOM
22324051;22324051-int;2579;3002;423;25/02/2021;202104;60;DOM
22324052;22324052-int;280;321;41;25/02/2021;202104;60;DOM
22324053;22324053-int;661;729;68;25/02/2021;202104;60;DOM
22324054;22324054-int;1003;1213;210;25/02/2021;202104;60;DOM
22324056;22324056-int;1153;1297;144;25/02/2021;202104;60;DOM
22324057;22324057-int;323;376;53;25/02/2021;202104;60;DOM
22324058;22324058-int;242;300;58;25/02/2021;202104;60;DOM
22324059;22324059-int;261;261;0;25/02/2021;202104;60;DOM
22324060;22324060-int;186;237;51;25/02/2021;202104;60;DOM
22324061;22324061-int;168;200;32;25/02/2021;202104;60;DOM
22324062;22324062-int;54;73;19;25/02/2021;202104;60;DOM
22324063;22324063-int;137;157;20;25/02/2021;202104;60;DOM
22324064;22324064-int;114;114;0;25/02/2021;202104;60;DOM
22324065;22324065-int;136;145;9;25/02/2021;202104;60;DOM
22324066;22324066-int;101;118;17;25/02/2021;202104;60;DOM
22324067;22324067-int;551;600;49;25/02/2021;202104;60;DOM
22324068;22324068-int;7402;8257;855;25/02/2021;202104;60;DOM
22324070;22324070-int;44;132;88;25/02/2021;202104;60;DOM
22324071;22324071-int;180;180;0;25/02/2021;202104;60;DOM
22324072;22324072-int;864;1013;149;25/02/2021;202104;60;DOM
22324073;22324073-int;93;95;2;25/02/2021;202104;60;DOM
22324074;22324074-int;365;444;79;25/02/2021;202104;60;DOM
22324076;22324076-int;899;1119;220;25/02/2021;202104;60;DOM
22324077;22324077-int;97;118;21;25/02/2021;202104;60;DOM
22324078;22324078-int;1742;2075;333;25/02/2021;202104;60;DOM
22324080;22324080-int;498;586;88;25/02/2021;202104;60;DOM
22324081;22324081-int;321;369;48;25/02/2021;202104;60;DOM
22324082;22324082-int;62;92;30;25/02/2021;202104;60;DOM
22324083;22324083-int;119;138;19;25/02/2021;202104;60;DOM
22324084;22324084-int;803;834;31;25/02/2021;202104;60;DOM
22324085;22324085-int;261;343;82;25/02/2021;202104;60;DOM
22324086;22324086-int;656;787;131;25/02/2021;202104;60;DOM
22324087;22324087-int;94;110;16;25/02/2021;202104;60;DOM
22324088;22324088-int;85;102;17;25/02/2021;202104;60;DOM
22324091;22324091-int;292;294;2;25/02/2021;202104;60;DOM
22324092;22324092-int;1326;1500;174;25/02/2021;202104;60;DOM
22324093;22324093-int;341;418;77;25/02/2021;202104;60;DOM
22324094;22324094-int;129;210;81;25/02/2021;202104;60;DOM
22324096;22324096-int;255;280;25;25/02/2021;202104;60;DOM
22324097;22324097-int;207;288;81;25/02/2021;202104;60;DOM
22324098;22324098-int;50;66;16;25/02/2021;202104;60;DOM
22324099;22324099-int;82;97;15;25/02/2021;202104;60;DOM
22324100;22324100-int;91;113;22;25/02/2021;202104;60;DOM
22324101;22324101-int;668;799;131;25/02/2021;202104;60;PROD
22324103;22324103-int;625;717;92;25/02/2021;202104;60;DOM
22324104;22324104-int;83;103;20;25/02/2021;202104;60;DOM
22324105;22324105-int;1312;1335;23;25/02/2021;202104;60;DOM
22324107;22324107-int;1710;2037;327;25/02/2021;202104;60;DOM
22324108;22324108-int;176;223;47;25/02/2021;202104;60;DOM
22324110;22324110-int;1608;1744;136;25/02/2021;202104;60;DOM
22324111;22324111-int;123;144;21;25/02/2021;202104;60;DOM
22324112;22324112-int;178;223;45;25/02/2021;202104;60;DOM
22324113;22324113-int;31;35;4;25/02/2021;202104;60;DOM
22324114;37219566132-9;24;184;160;25/02/2021;202104;60;DOM
22324115;22324115-int;1179;1266;87;25/02/2021;202104;60;DOM
22324117;22324117-int;281;302;21;25/02/2021;202104;60;DOM
22324118;22324118-int;59;69;10;25/02/2021;202104;60;DOM
22324119;22324119-int;109;134;25;25/02/2021;202104;60;DOM
22324121;22324121-int;2;2;0;25/02/2021;202104;60;DOM
22324124;22324124-int;358;456;98;25/02/2021;202104;60;DOM
22324125;22324125-int;645;645;0;25/02/2021;202104;60;PROD
22324126;22324126-int;65;74;9;25/02/2021;202104;60;PROD
22324127;22324127-int;17;20;3;25/02/2021;202104;60;DOM
22324130;22324130-int;34;41;7;25/02/2021;202104;60;DOM
22324132;22324132-int;300;339;39;25/02/2021;202104;60;DOM
22324133;22324133-int;63;76;13;25/02/2021;202104;60;DOM
22324134;22324134-int;45;85;40;25/02/2021;202104;60;DOM
22324135;22324135-int;3;5;2;25/02/2021;202104;60;DOM
22324136;22324136-int;79;97;18;25/02/2021;202104;60;DOM
22324137;22324137-int;21;29;8;25/02/2021;202104;60;DOM
22324140;22324140-int;689;812;123;25/02/2021;202104;60;DOM
22324142;22324142-int;725;833;108;25/02/2021;202104;60;PROD
22324146;22324146-int;689;866;177;25/02/2021;202104;60;DOM
22324147;22324147-int;129;191;62;25/02/2021;202104;60;DOM
22324148;22324148-int;186;236;50;25/02/2021;202104;60;DOM
22324149;22324149-int;1330;1585;255;25/02/2021;202104;60;DOM
22324151;22324151-int;170;202;32;25/02/2021;202104;60;DOM
22324152;22324152-int;52;60;8;25/02/2021;202104;60;DOM
22324153;22324153-int;220;737;517;25/02/2021;202104;60;DOM
22324155;22324155-int;0;147;147;25/02/2021;202104;60;DOM
22324160;37219564533-0;385;421;36;25/02/2021;202104;60;DOM
22324161;37219566041-2;25;32;7;25/02/2021;202104;60;DOM
22501003;22501003-int;241;273;32;25/02/2021;202104;60;DOM
22501004;150303-0270;12685;13125;440;25/02/2021;202104;60;PROD
22501006;22501006-int;33795;33795;0;25/02/2021;202104;60;PROD
22501007;150303-0332;12207;12403;196;25/02/2021;202104;60;DOM
22501008;150303-0226;9079;9533;454;25/02/2021;202104;60;DOM
22501010;22501010-int;213;227;14;25/02/2021;202104;60;DOM
22501020;150303-0385;7535;8058;523;25/02/2021;202104;60;DOM
22501021;150303-0215;6461;6474;13;25/02/2021;202104;60;PROD
22501022;22501022-int;185;213;28;25/02/2021;202104;60;DOM
22501026;22501026-int;70;121;51;25/02/2021;202104;60;DOM
22501033;22501033-int;8550;8591;41;25/02/2021;202104;60;DOM
22501034;22501034-int;384;438;54;25/02/2021;202104;60;DOM
22501039;22501039-int;12550;12721;171;25/02/2021;202104;60;PROD
22501040;22501040-int;8294;8695;401;25/02/2021;202104;60;PROD
22501041;150303-0052;15766;15766;0;25/02/2021;202104;60;DOM
22501045;150303-0459;4859;5099;240;25/02/2021;202104;60;DOM
22501046;150303-0247;8432;8657;225;25/02/2021;202104;60;DOM
22501048;150303-0217;3393;3407;14;25/02/2021;202104;60;DOM
22501049;150303-0475;8896;9243;347;25/02/2021;202104;60;DOM
22501055;150303-0476;5819;6039;220;25/02/2021;202104;60;DOM
22501061;150303-0214;8592;8630;38;25/02/2021;202104;60;DOM
22501063;150303-0473;8685;8902;217;25/02/2021;202104;60;DOM
22501064;150303-0145;8674;8909;235;25/02/2021;202104;60;DOM
22501065;22501065-int;48;73;25;25/02/2021;202104;60;DOM
22501068;150303-0175;6300;6410;110;25/02/2021;202104;60;DOM
22501069;150303-0474;1782;1825;43;25/02/2021;202104;60;DOM
22501070;150303-0228;9473;9678;205;25/02/2021;202104;60;DOM
22501071;150303-0216;2051;2140;89;25/02/2021;202104;60;DOM
22501072;37219567080-9;126;263;137;25/02/2021;202104;60;DOM
22501075;22501075-int;2562;2654;92;25/02/2021;202104;60;DOM
22501076;150303-0110;1559;1612;53;25/02/2021;202104;60;DOM
22501088;150303-0018;5082;5126;44;25/02/2021;202104;60;DOM
22501090;22501090-int;316;378;62;25/02/2021;202104;60;DOM
22501098;22501098-int;786;854;68;25/02/2021;202104;60;DOM
22501101;22501101-int;206;232;26;25/02/2021;202104;60;DOM
22501102;170809-0290;1544;1630;86;25/02/2021;202104;60;DOM
22501103;22501103-int;2901;3059;158;25/02/2021;202104;60;DOM
22501105;22501105-int;552;600;48;25/02/2021;202104;60;DOM
22501107;22501107-int;401;430;29;25/02/2021;202104;60;DOM
22501109;22501109-int;683;763;80;25/02/2021;202104;60;DOM
22501111;22501111-int;312;347;35;25/02/2021;202104;60;DOM
22501112;22501112-int;135;162;27;25/02/2021;202104;60;DOM
22501115;37219576370-3;14;25;11;25/02/2021;202104;60;DOM
22501116;22501116-int;360;408;48;25/02/2021;202104;60;DOM
22501118;22501118-int;368;394;26;25/02/2021;202104;60;DOM
22501119;22501119-int;1137;1343;206;25/02/2021;202104;60;DOM
22501120;37219567122-9;36;56;20;25/02/2021;202104;60;DOM
22501121;37219576826-4;16;32;16;25/02/2021;202104;60;DOM
22501122;22501122-int;3230;3605;375;25/02/2021;202104;60;DOM
22501124;22501124-int;234;251;17;25/02/2021;202104;60;DOM
22501125;22501125-int;45;56;11;25/02/2021;202104;60;DOM
22501126;22501126-int;166;191;25;25/02/2021;202104;60;DOM
22501128;22501128-int;217;235;18;25/02/2021;202104;60;DOM
22501129;37219566991-8;40;68;28;25/02/2021;202104;60;DOM
22501131;22501131-int;68;75;7;25/02/2021;202104;60;DOM
22501132;22501132-int;276;311;35;25/02/2021;202104;60;DOM
22501135;22501135-int;436;474;38;25/02/2021;202104;60;DOM
22501136;22501136-int;1880;2160;280;25/02/2021;202104;60;DOM
22501137;22501137-int;507;585;78;25/02/2021;202104;60;DOM
22501138;22501138-int;375;413;38;25/02/2021;202104;60;DOM
22501139;22501139-int;224;253;29;25/02/2021;202104;60;DOM
22501141;22501141-int;95;103;8;25/02/2021;202104;60;DOM
22501143;37219576503-9;25;61;36;25/02/2021;202104;60;DOM
22501144;37219565704-6;31;50;19;25/02/2021;202104;60;DOM
22501145;37219565845-7;15;34;19;25/02/2021;202104;60;DOM
22501146;22501146-int;152;180;28;25/02/2021;202104;60;DOM
22501147;22501147-int;4289;4740;451;25/02/2021;202104;60;DOM
22501149;22501149-int;145;161;16;25/02/2021;202104;60;DOM
22501150;37219576263-0;37;90;53;25/02/2021;202104;60;DOM
22501151;37219576248-1;18;31;13;25/02/2021;202104;60;DOM
22501152;22501152-int;294;321;27;25/02/2021;202104;60;DOM
22501153;22501153-int;1649;1881;232;25/02/2021;202104;60;DOM
22501154;22501154-int;7;14;7;25/02/2021;202104;60;DOM
22501155;22501155-int;327;404;77;25/02/2021;202104;60;DOM
22501156;37219567049-4;21;37;16;25/02/2021;202104;60;DOM
22501158;22501158-int;82;104;22;25/02/2021;202104;60;DOM
22501159;22501159-int;367;451;84;25/02/2021;202104;60;DOM
22501160;37219576230-9;34;66;32;25/02/2021;202104;60;DOM
22501161;37219564541-1;46;54;8;25/02/2021;202104;60;DOM
22501162;22501162-int;279;312;33;25/02/2021;202104;60;DOM
22501163;22501163-int;1921;2012;91;25/02/2021;202104;60;DOM
22501164;22501164-int;108;132;24;25/02/2021;202104;60;DOM
22501165;22501165-int;7375;7721;346;25/02/2021;202104;60;DOM
22501167;22501167-int;249;299;50;25/02/2021;202104;60;DOM
22501168;22501168-int;374;438;64;25/02/2021;202104;60;DOM
22501169;37219576552-6;10;22;12;25/02/2021;202104;60;DOM
22501170;37219576852-3;77;123;46;25/02/2021;202104;60;DOM
22501171;37219576578-1;57;74;17;25/02/2021;202104;60;DOM
22501172;22501172-int;185;214;29;25/02/2021;202104;60;DOM
22501173;37219576560-9;19;28;9;25/02/2021;202104;60;DOM
22501174;37219576560-9;80;101;21;25/02/2021;202104;60;DOM
22501175;37219565803-6;9;15;6;25/02/2021;202104;60;DOM
22501176;37219563634-7;3;4;1;25/02/2021;202104;60;DOM
22501177;37219567106-2;12;35;23;25/02/2021;202104;60;DOM
22501178;37219567254-0;24;38;14;25/02/2021;202104;60;DOM
22501179;22501179-int;2023;2313;290;25/02/2021;202104;60;DOM
22501180;37219576255-6;80;244;164;25/02/2021;202104;60;DOM
22501181;37219576610-2;19;36;17;25/02/2021;202104;60;DOM
22501182;37219565837-4;22;46;24;25/02/2021;202104;60;DOM
22501183;37219576362-0;114;216;102;25/02/2021;202104;60;DOM
22501184;37219576644-1;39;65;26;25/02/2021;202104;60;DOM
22501185;37219576768-8;45;82;37;25/02/2021;202104;60;DOM
22501186;37219565092-6;49;91;42;25/02/2021;202104;60;DOM
22501188;37219577048-4;10;24;14;25/02/2021;202104;60;DOM
22523001;22523001-int;39725;41792;2067;25/02/2021;202104;60;PROD
22523002;22523002-int;24314;24314;0;25/02/2021;202104;60;PROD
22523003;22523003-int;6858;7227;369;25/02/2021;202104;60;PROD
22523004;22523004-int;910;972;62;25/02/2021;202104;60;PROD
22523005;37219568765-4;143;195;52;25/02/2021;202104;60;DOM
22523006;22523006-int;1362;1802;440;25/02/2021;202104;60;DOM
22523007;22523007-int;788;993;205;25/02/2021;202104;60;DOM
22523008;22523008-int;235;279;44;25/02/2021;202104;60;DOM
22523009;22523009-int;99;120;21;25/02/2021;202104;60;DOM
22523010;22523010-int;2113;2331;218;25/02/2021;202104;60;DOM
22523011;22523011-int;203;237;34;25/02/2021;202104;60;DOM
22523012;22523012-int;690;815;125;25/02/2021;202104;60;DOM
22523013;22523013-int;62;72;10;25/02/2021;202104;60;DOM
22523014;22523014-int;653;697;44;25/02/2021;202104;60;DOM
22523015;22523015-int;98;117;19;25/02/2021;202104;60;DOM
22523016;22523016-int;270;346;76;25/02/2021;202104;60;DOM
22523017;22523017-int;163;191;28;25/02/2021;202104;60;DOM
22523018;22523018-int;513;579;66;25/02/2021;202104;60;DOM
22523019;22523019-int;2019;2229;210;25/02/2021;202104;60;DOM
22523020;22523020-int;348;394;46;25/02/2021;202104;60;DOM
22523022;22523022-int;70;87;17;25/02/2021;202104;60;DOM
22523023;22523023-int;183;228;45;25/02/2021;202104;60;DOM
22523024;22523024-int;1351;1543;192;25/02/2021;202104;60;DOM
22523025;22523025-int;87;104;17;25/02/2021;202104;60;DOM
22523026;22523026-int;309;334;25;25/02/2021;202104;60;DOM
22523027;22523027-int;1207;1394;187;25/02/2021;202104;60;DOM
22523028;22523028-int;87;116;29;25/02/2021;202104;60;DOM
22523029;22523029-int;855;950;95;25/02/2021;202104;60;DOM
22523030;22523030-int;4407;5326;919;25/02/2021;202104;60;DOM
22523031;22523031-int;2044;2337;293;25/02/2021;202104;60;DOM
22523032;22523032-int;2119;2119;0;25/02/2021;202104;60;PROD
22523033;22523033-int;918;1099;181;25/02/2021;202104;60;DOM
22523034;22523034-int;77;91;14;25/02/2021;202104;60;DOM
22523036;22523036-int;935;1091;156;25/02/2021;202104;60;DOM
22523037;22523037-int;243;306;63;25/02/2021;202104;60;DOM
22523038;22523038-int;143;163;20;25/02/2021;202104;60;DOM
22523039;22523039-int;511;699;188;25/02/2021;202104;60;DOM
22523040;22523040-int;477;477;0;25/02/2021;202104;60;DOM
22523041;37219574607-0;76;104;28;25/02/2021;202104;60;DOM
22523042;22523042-int;1872;2076;204;25/02/2021;202104;60;DOM
22523043;22523043-int;720;823;103;25/02/2021;202104;60;DOM
22523044;22523044-int;1235;1417;182;25/02/2021;202104;60;DOM
22523045;22523045-int;118;144;26;25/02/2021;202104;60;DOM
22523046;22523046-int;59;72;13;25/02/2021;202104;60;DOM
22523047;22523047-int;169;237;68;25/02/2021;202104;60;DOM
22523048;22523048-int;422;512;90;25/02/2021;202104;60;DOM
22523049;22523049-int;214;254;40;25/02/2021;202104;60;DOM
22523050;22523050-int;621;722;101;25/02/2021;202104;60;DOM
22523051;22523051-int;160;203;43;25/02/2021;202104;60;DOM
22523052;22523052-int;87;107;20;25/02/2021;202104;60;DOM
22523053;22523053-int;379;425;46;25/02/2021;202104;60;DOM
22523054;22523054-int;2195;2269;74;25/02/2021;202104;60;DOM
22523055;22523055-int;1846;1861;15;25/02/2021;202104;60;DOM
22523056;22523056-int;980;1122;142;25/02/2021;202104;60;DOM
22523057;22523057-int;845;997;152;25/02/2021;202104;60;DOM
22523058;22523058-int;307;374;67;25/02/2021;202104;60;DOM
22523059;22523059-int;1607;1823;216;25/02/2021;202104;60;DOM
22523060;22523060-int;67;78;11;25/02/2021;202104;60;DOM
22523061;22523061-int;438;486;48;25/02/2021;202104;60;DOM
22523062;22523062-int;1372;1720;348;25/02/2021;202104;60;DOM
22523063;22523063-int;143;161;18;25/02/2021;202104;60;DOM
22523064;22523064-int;23;46;23;25/02/2021;202104;60;DOM
22523066;22523066-int;114;143;29;25/02/2021;202104;60;DOM
22523067;37219565811-9;29;50;21;25/02/2021;202104;60;DOM
22523068;22523068-int;1445;1706;261;25/02/2021;202104;60;DOM
22523069;22523069-int;2149;2468;319;25/02/2021;202104;60;PROD
22523070;37219574557-7;29;57;28;25/02/2021;202104;60;DOM
22523071;22523071-int;159;179;20;25/02/2021;202104;60;DOM
22523072;22523072-int;273;285;12;25/02/2021;202104;60;DOM
22523073;22523073-int;277;330;53;25/02/2021;202104;60;DOM
22523074;22523074-int;1786;2162;376;25/02/2021;202104;60;DOM
22523075;22523075-int;76;119;43;25/02/2021;202104;60;DOM
22523076;22523076-int;141;176;35;25/02/2021;202104;60;DOM
22523077;22523077-int;186;206;20;25/02/2021;202104;60;DOM
22523078;22523078-int;13;20;7;25/02/2021;202104;60;DOM
22523079;22523079-int;305;356;51;25/02/2021;202104;60;DOM
22523080;22523080-int;1181;1203;22;25/02/2021;202104;60;DOM
22523081;22523081-int;105;133;28;25/02/2021;202104;60;DOM
22523082;22523082-int;352;746;394;25/02/2021;202104;60;DOM
22523083;22523083-int;28;66;38;25/02/2021;202104;60;DOM
22523084;22523084-int;418;484;66;25/02/2021;202104;60;DOM
22523085;22523085-int;271;321;50;25/02/2021;202104;60;DOM
22523086;22523086-int;1238;1325;87;25/02/2021;202104;60;DOM
22523087;22523087-int;257;738;481;25/02/2021;202104;60;DOM
22523088;22523088-int;12754;14117;1363;25/02/2021;202104;60;DOM
22523089;22523089-int;51;65;14;25/02/2021;202104;60;DOM
22523090;22523090-int;644;792;148;25/02/2021;202104;60;DOM
22523092;22523092-int;1748;2046;298;25/02/2021;202104;60;DOM
22523093;22523093-int;162;230;68;25/02/2021;202104;60;DOM
22523094;22523094-int;209;240;31;25/02/2021;202104;60;DOM
22523095;22523095-int;93;111;18;25/02/2021;202104;60;DOM
22523096;22523096-int;72;104;32;25/02/2021;202104;60;DOM
22523097;22523097-int;495;495;0;25/02/2021;202104;60;DOM
22523098;22523098-int;667;667;0;25/02/2021;202104;60;DOM
22523099;22523099-int;262;302;40;25/02/2021;202104;60;DOM
22523100;22523100-int;23;32;9;25/02/2021;202104;60;DOM
22523101;22523101-int;12;14;2;25/02/2021;202104;60;DOM
22523102;22523102-int;18;19;1;25/02/2021;202104;60;DOM
22523103;22523103-int;2335;2624;289;25/02/2021;202104;60;PROD
22523104;22523104-int;271;324;53;25/02/2021;202104;60;DOM
22523105;22523105-int;468;474;6;25/02/2021;202104;60;DOM
22523106;22523106-int;151;175;24;25/02/2021;202104;60;DOM
22523107;37219568658-1;44;75;31;25/02/2021;202104;60;DOM
22523108;37219573450-6;186;232;46;25/02/2021;202104;60;DOM
22523109;82450684;86;93;7;25/02/2021;202104;60;DOM
22523110;22523110-int;32;46;14;25/02/2021;202104;60;DOM
22523113;22523113-int;1425;1596;171;25/02/2021;202104;60;PROD
22523114;37219564574-4;18;51;33;25/02/2021;202104;60;DOM
22523115;37219579564-8;594;745;151;25/02/2021;202104;60;DOM
22523116;70002941436;0;0;0;25/02/2021;202104;60;PROD
22523117;37219574953-8;48;77;29;25/02/2021;202104;60;DOM
22523118;37219563246-0;632;720;88;25/02/2021;202104;60;DOM
22523119;37219568815-7;36;54;18;25/02/2021;202104;60;DOM
22523120;37219574979-3;29;96;67;25/02/2021;202104;60;DOM
22523121;37219568799-3;19;57;38;25/02/2021;202104;60;DOM
22523122;37219575000-7;140;391;251;25/02/2021;202104;60;DOM
22523123;37219568647-1;29;45;16;25/02/2021;202104;60;DOM
22523124;37219574987-6;0;0;0;25/02/2021;202104;60;DOM
22523125;37219574961-1;211;267;56;25/02/2021;202104;60;DOM
22523126;37219567257-9;9;93;84;25/02/2021;202104;60;DOM
22523127;37219573088-4;14;29;15;25/02/2021;202104;60;DOM
22523129;37219575737-4;21;46;25;25/02/2021;202104;60;DOM
22523132;3721957554-3;22;29;7;25/02/2021;202104;60;DOM
22523139;37219576685-4;17;42;25;25/02/2021;202104;60;DOM
22523140;37219573062-9;502;1044;542;25/02/2021;202104;60;DOM
22523142;37219574508-0;119;244;125;25/02/2021;202104;60;DOM
22523143;22523143-int;2689;3579;890;25/02/2021;202104;60;PROD
22523144;37219574920-7;5;11;6;25/02/2021;202104;60;DOM
22523145;37219564996-9;27;33;6;25/02/2021;202104;60;PROD
22523148;37219575257-3;405;850;445;25/02/2021;202104;60;DOM
22523152;3721957554-3;5;9;4;25/02/2021;202104;60;DOM
22523153;37219576651-6;45;88;43;25/02/2021;202104;60;DOM
22523154;37219562883-1;163;409;246;25/02/2021;202104;60;DOM
22523155;37219574482-8;19;93;74;25/02/2021;202104;60;DOM
22523158;37219563147-0;101;217;116;25/02/2021;202104;60;DOM
22523176;14225393710;3715;4098;383;25/02/2021;202104;60;PROD
22528001;150303-0109;1705;1728;23;25/02/2021;202104;60;DOM
22528002;150303-0079;8929;9253;324;25/02/2021;202104;60;DOM
22528003;22528003-int;65;85;20;25/02/2021;202104;60;DOM
22528006;22528006-int;138;164;26;25/02/2021;202104;60;DOM
22528007;22528007-int;16087;16350;263;25/02/2021;202104;60;PROD
22528013;22528013-int;660;740;80;25/02/2021;202104;60;DOM
22528022;22528022-int;0;34;34;25/02/2021;202104;60;DOM
22528024;170809-0279;7856;8187;331;25/02/2021;202104;60;DOM
22528025;22528025-int;190;231;41;25/02/2021;202104;60;DOM
22528042;22528042-int;5523;5587;64;25/02/2021;202104;60;PROD
22528043;170809-0025;4636;4770;134;25/02/2021;202104;60;DOM
22528044;37219563204-9;478;478;0;25/02/2021;202104;60;DOM
22528047;22528047-int;3470;3884;414;25/02/2021;202104;60;DOM
22528048;22528048-int;214;284;70;25/02/2021;202104;60;PROD
22531001;22531001-int;35189;35599;410;25/02/2021;202104;60;PROD
22531002;22531002-int;155;185;30;25/02/2021;202104;60;DOM
22531003;22531003-int;394;427;33;25/02/2021;202104;60;DOM
22531004;22531004-int;30;33;3;25/02/2021;202104;60;DOM
22531005;22531005-int;457;489;32;25/02/2021;202104;60;DOM
22531006;22531006-int;431;479;48;25/02/2021;202104;60;DOM
22531007;22531007-int;216;245;29;25/02/2021;202104;60;DOM
22531008;22531008-int;1305;1403;98;25/02/2021;202104;60;DOM
22531009;22531009-int;51;55;4;25/02/2021;202104;60;DOM
22531010;22531010-int;153;171;18;25/02/2021;202104;60;DOM
22531011;22531011-int;823;957;134;25/02/2021;202104;60;DOM
22531012;3729568781-1;12;25;13;25/02/2021;202104;60;DOM
22531013;22531013-int;172;197;25;25/02/2021;202104;60;DOM
22531014;22531014-int;2744;2996;252;25/02/2021;202104;60;DOM
22531015;22531015-int;252;292;40;25/02/2021;202104;60;DOM
22531016;22531016-int;459;590;131;25/02/2021;202104;60;DOM
22531017;22531017-int;399;470;71;25/02/2021;202104;60;DOM
22531018;22531018-int;271;299;28;25/02/2021;202104;60;DOM
22531019;22531019-int;99;106;7;25/02/2021;202104;60;DOM
22531020;22531020-int;1781;1804;23;25/02/2021;202104;60;DOM
22531021;22531021-int;972;991;19;25/02/2021;202104;60;DOM
22531022;22531022-int;2707;2983;276;25/02/2021;202104;60;DOM
22531023;22531023-int;1230;1519;289;25/02/2021;202104;60;DOM
22531024;22531024-int;200;222;22;25/02/2021;202104;60;DOM
22531025;22531025-int;674;721;47;25/02/2021;202104;60;DOM
22531026;37219568716-7;81;114;33;25/02/2021;202104;60;DOM
22531027;22531027-int;1364;1499;135;25/02/2021;202104;60;DOM
22531029;22531029-int;2374;2422;48;25/02/2021;202104;60;DOM
22531030;22531030-int;133;148;15;25/02/2021;202104;60;DOM
22531031;37219568740-7;8;16;8;25/02/2021;202104;60;DOM
22531032;37219568757-1;8;16;8;25/02/2021;202104;60;DOM
22531033;22531033-int;263;285;22;25/02/2021;202104;60;DOM
22531034;37219568732-4;10;18;8;25/02/2021;202104;60;DOM
22531037;22531037-int;2158;2242;84;25/02/2021;202104;60;PROD
22531038;22531038-int;6285;6672;387;25/02/2021;202104;60;DOM
22531039;22531039-int;49835;49835;0;25/02/2021;202104;60;PROD
22531040;37219568690-4;701;893;192;25/02/2021;202104;60;DOM
22531041;37219568609-4;50;76;26;25/02/2021;202104;60;DOM
22531042;37219574490-1;0;2;2;25/02/2021;202104;60;DOM
22531043;14225394015;6098;11703;5605;25/02/2021;202104;60;PROD
22701009;150303-0258;3616;3664;48;25/02/2021;202104;60;DOM
22701010;150303-0323;2141;2174;33;25/02/2021;202104;60;DOM
22701021;150303-0075;1377;1452;75;25/02/2021;202104;60;DOM
22701023;170809-0079;651;669;18;25/02/2021;202104;60;DOM
22701024;22701024-int;102;126;24;25/02/2021;202104;60;DOM
22701025;22701025-int;189;273;84;25/02/2021;202104;60;DOM
22701026;22701026-int;22;28;6;25/02/2021;202104;60;DOM
22701027;22701027-int;1139;1432;293;25/02/2021;202104;60;DOM
22701029;22701029-int;1022;1215;193;25/02/2021;202104;60;DOM
22701030;22701030-int;14;56;42;25/02/2021;202104;60;DOM
22701031;22701031-int;583;611;28;25/02/2021;202104;60;DOM
22701032;22701032-int;1628;2007;379;25/02/2021;202104;60;DOM
22701034;37219579036-2;1325;1327;2;25/02/2021;202104;60;PROD
22702001;150303-0150;1870;1893;23;25/02/2021;202104;60;DOM
22702003;150303-0286;13716;14260;544;25/02/2021;202104;60;DOM
22702006;150303-0274;2844;3500;656;25/02/2021;202104;60;DOM
22702007;150303-0307;3444;3507;63;25/02/2021;202104;60;DOM
22702008;22702008-int;367;438;71;25/02/2021;202104;60;DOM
22702015;150303-0297;1413;1461;48;25/02/2021;202104;60;PROD
22702017;22702017-int;18461;18698;237;25/02/2021;202104;60;PROD
22702026;22702026-int;94;139;45;25/02/2021;202104;60;DOM
22702027;22702027-int;80;107;27;25/02/2021;202104;60;DOM
22702028;22702028-int;436;486;50;25/02/2021;202104;60;DOM
22702029;22702029-int;74;93;19;25/02/2021;202104;60;DOM
22703007;22703007-int;3143;3314;171;25/02/2021;202104;60;DOM
22703010;22703010-int;208;664;456;25/02/2021;202104;60;DOM
22703012;22703012-int;134;273;139;25/02/2021;202104;60;DOM
22703013;22703013-int;88;110;22;25/02/2021;202104;60;DOM
22703014;22703014-int;79;91;12;25/02/2021;202104;60;DOM
22703015;22703015-int;493;595;102;25/02/2021;202104;60;DOM
22704003;150303-0287;3877;3897;20;25/02/2021;202104;60;DOM
22704004;37219562859-1;503;1106;603;25/02/2021;202104;60;DOM
22704005;150303-0358;6398;6471;73;25/02/2021;202104;60;DOM
22704006;150303-0288;9009;9398;389;25/02/2021;202104;60;DOM
22704007;150303-0040;5981;6147;166;25/02/2021;202104;60;DOM
22704008;150303-0360;12005;12278;273;25/02/2021;202104;60;DOM
22704009;150303-0357;1694;1788;94;25/02/2021;202104;60;PROD
22704013;22704013-int;24001;24851;850;25/02/2021;202104;60;PROD
22704014;150303-0190;3533;3599;66;25/02/2021;202104;60;DOM
22704015;150303-0275;8362;8365;3;25/02/2021;202104;60;PROD
22704016;150303-0376;2704;2742;38;25/02/2021;202104;60;DOM
22704018;150303-0129;2698;2859;161;25/02/2021;202104;60;PROD
22704019;150303-0197;8961;9052;91;25/02/2021;202104;60;DOM
22704020;22704020-int;1231;1239;8;25/02/2021;202104;60;PROD
22704021;150303-0199;1766;1779;13;25/02/2021;202104;60;DOM
22704022;150303-0470;6143;6300;157;25/02/2021;202104;60;DOM
22704023;22704023-int;6745;6745;0;25/02/2021;202104;60;PROD
22704026;170809-0150;1317;1399;82;25/02/2021;202104;60;DOM
22704027;150303-0032;3390;3570;180;25/02/2021;202104;60;DOM
22704028;170404-0015;2419;2489;70;25/02/2021;202104;60;DOM
22704030;170404-0014;4921;5249;328;25/02/2021;202104;60;DOM
22704031;22704031-int;35968;36404;436;25/02/2021;202104;60;PROD
22704033;170809-0110;1632;1710;78;25/02/2021;202104;60;PROD
22704034;22704034-int;4625;4727;102;25/02/2021;202104;60;PROD
22704035;22704035-int;773;938;165;25/02/2021;202104;60;DOM
22704037;22704037-int;13630;13630;0;25/02/2021;202104;60;PROD
22704038;22704038-int;1492;1829;337;25/02/2021;202104;60;DOM
22704040;22704040-int;827;858;31;25/02/2021;202104;60;DOM
22704041;22704041-int;191;230;39;25/02/2021;202104;60;DOM
22704042;22704042-int;50;99;49;25/02/2021;202104;60;DOM
22704043;22704043-int;45;55;10;25/02/2021;202104;60;DOM
22704044;22704044-int;176;201;25;25/02/2021;202104;60;DOM
22704045;22704045-int;38;54;16;25/02/2021;202104;60;DOM
22704046;22704046-int;325;420;95;25/02/2021;202104;60;DOM
22704047;22704047-int;41;48;7;25/02/2021;202104;60;DOM
22704048;22704048-int;208;237;29;25/02/2021;202104;60;DOM
22704049;22704049-int;284;327;43;25/02/2021;202104;60;DOM
22704050;22704050-int;141;163;22;25/02/2021;202104;60;DOM
22704051;22704051-int;40;49;9;25/02/2021;202104;60;DOM
22704054;22704054-int;212;613;401;25/02/2021;202104;60;DOM
22704055;22704055-int;1685;1798;113;25/02/2021;202104;60;DOM
22705007;150303-0037;4146;4306;160;25/02/2021;202104;60;DOM
22705008;150303-0039;4249;4278;29;25/02/2021;202104;60;DOM
22705009;150303-0369;5110;5245;135;25/02/2021;202104;60;DOM
22705010;150303-0038;7324;7701;377;25/02/2021;202104;60;DOM
22705012;150303-0458;652;655;3;25/02/2021;202104;60;DOM
22705016;22705016-int;6790;6917;127;25/02/2021;202104;60;PROD
22705017;22705017-int;5079;5079;0;25/02/2021;202104;60;PROD
22705019;170303-0472;3456;3575;119;25/02/2021;202104;60;DOM
22705036;22705036-int;701;755;54;25/02/2021;202104;60;DOM
22705037;170809-0217;1535;1631;96;25/02/2021;202104;60;DOM
22705038;1503030192(1);1285;1305;20;25/02/2021;202104;60;DOM
22705040;22705040-int;823;823;0;25/02/2021;202104;60;DOM
22706001;22706001-int;35;49;14;25/02/2021;202104;60;PROD
22706002;22706002-int;50;50;0;25/02/2021;202104;60;PROD
22706003;22706003-int;15;20;5;25/02/2021;202104;60;DOM
22706004;22706004-int;18;20;2;25/02/2021;202104;60;DOM
22706005;22706005-int;67;86;19;25/02/2021;202104;60;DOM
22706006;22706006-int;4;6;2;25/02/2021;202104;60;DOM
22706008;22706008-int;31;40;9;25/02/2021;202104;60;DOM
22706009;22706009-int;25;28;3;25/02/2021;202104;60;DOM
22706010;22706010-int;12;14;2;25/02/2021;202104;60;DOM
22706012;22706012-int;1199;1345;146;25/02/2021;202104;60;DOM
22706013;22706013-int;51;52;1;25/02/2021;202104;60;DOM
22706014;22706014-int;120;154;34;25/02/2021;202104;60;DOM
22706015;22706015-int;17;22;5;25/02/2021;202104;60;DOM
22706016;22706016-int;15;17;2;25/02/2021;202104;60;DOM
22706017;22706017-int;22;27;5;25/02/2021;202104;60;DOM
22706018;22706018-int;9;12;3;25/02/2021;202104;60;DOM
22706019;22706019-int;951;1180;229;25/02/2021;202104;60;DOM
22706020;22706020-int;53;69;16;25/02/2021;202104;60;DOM
22706021;22706021-int;21;24;3;25/02/2021;202104;60;DOM
22706022;22706022-int;54;76;22;25/02/2021;202104;60;DOM
22706023;22706023-int;15;22;7;25/02/2021;202104;60;DOM
22706024;22706024-int;17;22;5;25/02/2021;202104;60;DOM
22706025;22706025-int;41;52;11;25/02/2021;202104;60;DOM
22706026;22706026-int;148;180;32;25/02/2021;202104;60;DOM
22706028;22706028-int;172;200;28;25/02/2021;202104;60;DOM
22706030;22706030-int;54;65;11;25/02/2021;202104;60;DOM
22706031;22706031-int;8;13;5;25/02/2021;202104;60;DOM
22706032;22706032-int;67;100;33;25/02/2021;202104;60;DOM
22706033;22706033-int;7;15;8;25/02/2021;202104;60;DOM
22706034;22706034-int;29;52;23;25/02/2021;202104;60;DOM
22706035;22706035-int;97;124;27;25/02/2021;202104;60;DOM
22706036;22706036-int;42;51;9;25/02/2021;202104;60;DOM
22706037;22706037-int;15;19;4;25/02/2021;202104;60;DOM
22706038;22706038-int;214;247;33;25/02/2021;202104;60;DOM
22706039;22706039-int;36;49;13;25/02/2021;202104;60;DOM
22706040;22706040-int;27;33;6;25/02/2021;202104;60;DOM
22706042;22706042-int;25;29;4;25/02/2021;202104;60;DOM
22706045;22706045-int;528;619;91;25/02/2021;202104;60;DOM
22706046;22706046-int;15;21;6;25/02/2021;202104;60;DOM
22706049;22706049-int;8;10;2;25/02/2021;202104;60;DOM
22706050;22706050-int;57;65;8;25/02/2021;202104;60;DOM
22706052;22706052-int;1176;1287;111;25/02/2021;202104;60;DOM
22706053;22706053-int;286;319;33;25/02/2021;202104;60;DOM
22706054;22706054-int;39;48;9;25/02/2021;202104;60;DOM
22706055;22706055-int;13;16;3;25/02/2021;202104;60;DOM
22706056;22706056-int;72;95;23;25/02/2021;202104;60;DOM
22706057;22706057-int;18;21;3;25/02/2021;202104;60;DOM
22706058;22706058-int;19;24;5;25/02/2021;202104;60;DOM
22706059;22706059-int;132;166;34;25/02/2021;202104;60;DOM
22706060;22706060-int;264;300;36;25/02/2021;202104;60;DOM
22706061;22706061-int;48;60;12;25/02/2021;202104;60;DOM
22706062;22706062-int;1742;2101;359;25/02/2021;202104;60;DOM
22706064;22706064-int;3567;3904;337;25/02/2021;202104;60;PROD
23401002;23401002-int;7809;7854;45;25/02/2021;202104;60;DOM
23401003;150303-0417;3246;3357;111;25/02/2021;202104;60;DOM
23401004;23401004-int;5818;6199;381;25/02/2021;202104;60;DOM
23401008;23401008-int;4664;4854;190;25/02/2021;202104;60;DOM
23401009;23401009-int;28637;28845;208;25/02/2021;202104;60;PROD
23401010;23401010-int;233684;237745;4061;25/02/2021;202104;60;PROD
23401013;37219579630-7;75;97;22;25/02/2021;202104;60;DOM
23401015;37219579622-4;235;242;7;25/02/2021;202104;60;DOM
23401017;23401017-int;354;391;37;25/02/2021;202104;60;DOM
23401020;37219579580-4;60;72;12;25/02/2021;202104;60;DOM
23401023;37219579598-6;226;376;150;25/02/2021;202104;60;DOM
23401026;23401026-int;84;103;19;25/02/2021;202104;60;DOM
23401030;37219563998-6;74;285;211;25/02/2021;202104;60;DOM
23401032;23401032-int;2758;2884;126;25/02/2021;202104;60;DOM
23401033;23401033-int;7914;8356;442;25/02/2021;202104;60;DOM
23401034;23401034-int;1253;1260;7;25/02/2021;202104;60;DOM
23401035;23401035-int;379;407;28;25/02/2021;202104;60;DOM
23401038;23401038-int;485;521;36;25/02/2021;202104;60;DOM
23401039;23401039-int;58;79;21;25/02/2021;202104;60;DOM
23401047;23401047-int;1119;1199;80;25/02/2021;202104;60;DOM
23401067;37219579531-7;100;175;75;25/02/2021;202104;60;DOM
23401072;23401072-int;870;993;123;25/02/2021;202104;60;DOM
23401073;150303-0078;3574;3717;143;25/02/2021;202104;60;DOM
23401076;37219564012-5;62;79;17;25/02/2021;202104;60;DOM
23401081;170809-0356;3222;3451;229;25/02/2021;202104;60;DOM
23401084;37219579515-0;621;747;126;25/02/2021;202104;60;DOM
23401087;170809-0341;4583;4846;263;25/02/2021;202104;60;DOM
23401090;23401090-int;2112;2394;282;25/02/2021;202104;60;DOM
23401091;23401091-int;1954;1955;1;25/02/2021;202104;60;DOM
23401092;23401092-int;398;490;92;25/02/2021;202104;60;DOM
23401093;23401093-int;245;257;12;25/02/2021;202104;60;PROD
23401094;23401094-int;1204;1421;217;25/02/2021;202104;60;DOM
23401095;23401095-int;437;492;55;25/02/2021;202104;60;DOM
23401096;1M01201701319;1062;1303;241;25/02/2021;202104;60;DOM
23401097;23401097-int;123;185;62;25/02/2021;202104;60;DOM
23401098;23401098-int;9;34;25;25/02/2021;202104;60;DOM
23401099;23401099-int;109;126;17;25/02/2021;202104;60;DOM
23401101;23401101-int;157;207;50;25/02/2021;202104;60;DOM
23401102;23401102-int;959;1099;140;25/02/2021;202104;60;DOM
23401103;23401103-int;134;161;27;25/02/2021;202104;60;DOM
23401104;23401104-int;712;760;48;25/02/2021;202104;60;DOM
23401105;23401105-int;1138;1195;57;25/02/2021;202104;60;PROD
23401106;23401106-int;5074;5964;890;25/02/2021;202104;60;DOM
23401107;23401107-int;73;101;28;25/02/2021;202104;60;DOM
23401113;23401113-int;97;123;26;25/02/2021;202104;60;DOM
23501003;23501003-int;0;58;58;25/02/2021;202104;60;DOM
23501009;150303-0305;9468;9894;426;25/02/2021;202104;60;DOM
23501010;150303-0308;7559;7783;224;25/02/2021;202104;60;DOM
23501012;23501012-int;15928;15928;0;25/02/2021;202104;60;PROD
23501014;150303-0341;12632;13091;459;25/02/2021;202104;60;DOM
23501015;23501015-int;22846;23455;609;25/02/2021;202104;60;PROD
23501017;23501017-int;339;364;25;25/02/2021;202104;60;DOM
23501024;23501024-int;4473;4644;171;25/02/2021;202104;60;DOM
23501025;170809-0347;1712;1892;180;25/02/2021;202104;60;DOM
23501032;170404-0051;2839;2937;98;25/02/2021;202104;60;DOM
23501033;150303-0087;8910;9258;348;25/02/2021;202104;60;DOM
23501054;170404-0034;7026;7264;238;25/02/2021;202104;60;DOM
23501055;23501055-int;1802;1972;170;25/02/2021;202104;60;DOM
23501056;145127-0407;5658;5959;301;25/02/2021;202104;60;DOM
23501057;37219575752-2;4;79;75;25/02/2021;202104;60;DOM
23501068;170809-0361;2771;2991;220;25/02/2021;202104;60;DOM
23501069;170809-0295;3623;3698;75;25/02/2021;202104;60;DOM
23501070;170809-0296;997;1046;49;25/02/2021;202104;60;DOM
23501072;23501072-int;2435;2540;105;25/02/2021;202104;60;DOM
23501073;23501073-int;2603;2662;59;25/02/2021;202104;60;DOM
23501074;23501074-int;1019;1238;219;25/02/2021;202104;60;DOM
23501075;23501075-int;155;190;35;25/02/2021;202104;60;DOM
23501076;23501076-int;786;792;6;25/02/2021;202104;60;DOM
23501077;23501077-int;594;632;38;25/02/2021;202104;60;DOM
23501078;1M02201101092;137;155;18;25/02/2021;202104;60;DOM
23501079;23501079-int;478;538;60;25/02/2021;202104;60;DOM
23501080;23501080-int;822;861;39;25/02/2021;202104;60;DOM
23501081;23501081-int;1187;1367;180;25/02/2021;202104;60;DOM
23501082;23501082-int;36;46;10;25/02/2021;202104;60;DOM
23501083;23501083-int;125;150;25;25/02/2021;202104;60;DOM
23501084;23501084-int;946;1077;131;25/02/2021;202104;60;DOM
23501085;23501085-int;41;93;52;25/02/2021;202104;60;DOM
23501086;23501086-int;773;962;189;25/02/2021;202104;60;DOM
23501087;23501087-int;41;53;12;25/02/2021;202104;60;DOM
23501088;23501088-int;1268;1408;140;25/02/2021;202104;60;DOM
23501089;23501089-int;154;165;11;25/02/2021;202104;60;DOM
23501090;37219567379-5;0;194;194;25/02/2021;202104;60;DOM
23501091;37219564970-4;0;27;27;25/02/2021;202104;60;DOM
23501092;37219568666-4;0;45;45;25/02/2021;202104;60;DOM
23501093;37219568591-4;0;67;67;25/02/2021;202104;60;DOM
23509003;23509003-int;12478;12554;76;25/02/2021;202104;60;PROD
23509004;37219575786-1;9;28;19;25/02/2021;202104;60;DOM
23509009;23509009-int;42;60;18;25/02/2021;202104;60;DOM
23509019;82450012�;64;78;14;25/02/2021;202104;60;DOM
23509020;150303-0080;2438;2492;54;25/02/2021;202104;60;DOM
23509021;170809-0104;3521;3677;156;25/02/2021;202104;60;DOM
23509029;23509029-int;776;804;28;25/02/2021;202104;60;DOM
23509035;23509035-int;636;685;49;25/02/2021;202104;60;DOM
23509048;23509048-int;6162;6256;94;25/02/2021;202104;60;PROD
23509054;170809-0176;4482;4532;50;25/02/2021;202104;60;PROD
23509056;23509056-int;4130;4410;280;25/02/2021;202104;60;DOM
23509057;23509057-int;4268;4699;431;25/02/2021;202104;60;DOM
23509058;23509058-int;1001;1012;11;25/02/2021;202104;60;DOM
23509059;23509059-int;727;828;101;25/02/2021;202104;60;DOM
23509060;2M02201000377;70;73;3;25/02/2021;202104;60;DOM
23509062;23509062-int;76;177;101;25/02/2021;202104;60;DOM
23509063;23509063-int;12;21;9;25/02/2021;202104;60;DOM
23509064;37219573716-7;184;214;30;25/02/2021;202104;60;DOM
24301005;24301005-int;1518;1756;238;25/02/2021;202104;60;DOM
24301009;150303-0053;5162;5420;258;25/02/2021;202104;60;DOM
24301013;150303-0424;8159;8260;101;25/02/2021;202104;60;DOM
24301026;170809-0325;4290;4556;266;25/02/2021;202104;60;DOM
24301027;170306-0030;4824;4920;96;25/02/2021;202104;60;DOM
24301028;170809-0281;340;353;13;25/02/2021;202104;60;DOM
24301030;24301030-int;99;112;13;25/02/2021;202104;60;DOM
24301032;24301032-int;1313;1541;228;25/02/2021;202104;60;DOM
24301033;24301033-int;1667;2052;385;25/02/2021;202104;60;DOM
24302003;150303-0381;5872;5998;126;25/02/2021;202104;60;DOM
24302005;24302005-int;15;19;4;25/02/2021;202104;60;DOM
24302008;170809-0023;1658;1754;96;25/02/2021;202104;60;DOM
24302013;150303-0425;7081;7195;114;25/02/2021;202104;60;DOM
24302014;170809-0147;1196;1353;157;25/02/2021;202104;60;DOM
24302020;150303-0374;3037;3246;209;25/02/2021;202104;60;DOM
24302023;24302023-int;558;783;225;25/02/2021;202104;60;DOM
24302024;170809-0057;2266;2355;89;25/02/2021;202104;60;DOM
24302026;150303-0229;8489;8815;326;25/02/2021;202104;60;DOM
24302027;150303-0434;6963;6963;0;25/02/2021;202104;60;DOM
24302029;150303-0243;7628;8106;478;25/02/2021;202104;60;DOM
24302033;24302033-int;1791;2048;257;25/02/2021;202104;60;DOM
24302038;24302038-int;16925;17301;376;25/02/2021;202104;60;PROD
24302039;150303-0388;380;424;44;25/02/2021;202104;60;DOM
24302041;24302041-int;15099;15438;339;25/02/2021;202104;60;PROD
24302045;24302045-int;337;354;17;25/02/2021;202104;60;DOM
24302052;24302052-int;56;78;22;25/02/2021;202104;60;DOM
24302068;170404-0046;2871;3041;170;25/02/2021;202104;60;DOM
24302071;170809-0323;284;299;15;25/02/2021;202104;60;DOM
24302073;37219564434-1;0;7;7;25/02/2021;202104;60;DOM
24302074;24302074-int;401;528;127;25/02/2021;202104;60;DOM
24302075;24302075-int;139;199;60;25/02/2021;202104;60;DOM
24302077;24302077-int;170;215;45;25/02/2021;202104;60;DOM
24302078;37219564715-3;0;0;0;25/02/2021;202104;60;DOM
24302079;37219567544-4;0;16;16;25/02/2021;202104;60;DOM
24302080;37219564905-0;0;17;17;25/02/2021;202104;60;DOM
24302081;37219579275-;242;264;22;25/02/2021;202104;60;DOM
24302082;37219579069-;71;76;5;25/02/2021;202104;60;DOM
24302084;37219565910-9;0;226;226;25/02/2021;202104;60;DOM
24303001;24303001-int;392;482;2;25/02/2021;202104;60;DOM
24303014;150303-0072;2295;2648;353;25/02/2021;202104;60;DOM
24303015;24303015-int;823;911;88;25/02/2021;202104;60;DOM
24303018;24303018-int;9981;10201;220;25/02/2021;202104;60;PROD
24303024;170404-0044;9481;9872;391;25/02/2021;202104;60;DOM
24303026;24303026-int;43;54;11;25/02/2021;202104;60;DOM
24303027;24303027-int;917;1136;219;25/02/2021;202104;60;DOM
24304004;24304004-int;89;104;15;25/02/2021;202104;60;DOM
24304007;150303-0435;6172;6284;112;25/02/2021;202104;60;DOM
24304009;150303-0067;4590;5050;460;25/02/2021;202104;60;DOM
24304012;24304012-int;39;120;81;25/02/2021;202104;60;DOM
24304017;150303-0045;7974;8372;398;25/02/2021;202104;60;DOM
24304021;24304021-int;764;826;62;25/02/2021;202104;60;DOM
24304025;170809-0358;1880;2046;166;25/02/2021;202104;60;DOM
24304029;37219576594-8;0;35;35;25/02/2021;202104;60;DOM
24304035;150303-0292;6157;6558;401;25/02/2021;202104;60;DOM
24304036;24304036-int;11643;12091;448;25/02/2021;202104;60;PROD
24304037;24304037-int;3185;3198;13;25/02/2021;202104;60;PROD
24304039;24304039-int;42938;44014;1076;25/02/2021;202104;60;PROD
24304040;24304040-int;440;573;133;25/02/2021;202104;60;PROD
24304041;41290299;7568;7776;208;25/02/2021;202104;60;PROD
24304042;24304042-int;29197;29859;662;25/02/2021;202104;60;PROD
24304043;24304043-int;2658;2708;50;25/02/2021;202104;60;DOM
24304044;150303-0188;6440;6701;261;25/02/2021;202104;60;DOM
24304050;150303-0054;5430;5606;176;25/02/2021;202104;60;DOM
24304051;150303-0191;1212;1270;58;25/02/2021;202104;60;DOM
24304056;170404-0043;3243;3323;80;25/02/2021;202104;60;DOM
24304057;170404-0041;2759;2790;31;25/02/2021;202104;60;DOM
24304058;24304058-int;32;42;10;25/02/2021;202104;60;DOM
24304068;24304068-int;155;188;33;25/02/2021;202104;60;DOM
24304070;24304070-int;4273;4307;34;25/02/2021;202104;60;PROD
24304071;24304071-int;5944;6072;128;25/02/2021;202104;60;PROD
24304072;24304072-int;185;198;13;25/02/2021;202104;60;DOM
24304073;24304073-int;90;108;18;25/02/2021;202104;60;DOM
24304075;24304075-int;45;56;11;25/02/2021;202104;60;DOM
24304076;24304076-int;44;53;9;25/02/2021;202104;60;DOM
24304078;24304078-int;82;101;19;25/02/2021;202104;60;DOM
24304079;24304079-int;21;40;19;25/02/2021;202104;60;DOM
24304080;24304080-int;94;113;19;25/02/2021;202104;60;DOM
24304081;24304081-int;125;164;39;25/02/2021;202104;60;DOM
24304083;24304083-int;124;146;22;25/02/2021;202104;60;DOM
24304084;24304084-int;95;113;18;25/02/2021;202104;60;DOM
24304085;24304085-int;243;298;55;25/02/2021;202104;60;DOM
24304087;24304087-int;37;51;14;25/02/2021;202104;60;DOM
24304088;24304088-int;2346;2749;403;25/02/2021;202104;60;DOM
24304089;24304089-int;119;146;27;25/02/2021;202104;60;DOM
24304090;24304090-int;96;114;18;25/02/2021;202104;60;DOM
24304091;24304091-int;680;875;195;25/02/2021;202104;60;DOM
24304093;1M05201500622;130;153;23;25/02/2021;202104;60;DOM
24304094;24304094-int;97;115;18;25/02/2021;202104;60;DOM
24304095;24304095-int;1226;1308;82;25/02/2021;202104;60;DOM
24304096;24304096-int;76;109;33;25/02/2021;202104;60;DOM
24304097;24304097-int;168;203;35;25/02/2021;202104;60;DOM
24304098;24304098-int;113;125;12;25/02/2021;202104;60;DOM
24304099;24304099-int;40;47;7;25/02/2021;202104;60;DOM
24304100;24304100-int;63;71;8;25/02/2021;202104;60;DOM
24304101;24304101-int;81;102;21;25/02/2021;202104;60;DOM
24304102;24304102-int;99;117;18;25/02/2021;202104;60;DOM
24304103;24304103-int;807;887;80;25/02/2021;202104;60;PROD
24304104;24304104-int;12;16;4;25/02/2021;202104;60;DOM
24304105;24304105-int;140;161;21;25/02/2021;202104;60;DOM
24304106;24304106-int;146;176;30;25/02/2021;202104;60;DOM
24304108;37219577865-1;278;302;24;25/02/2021;202104;60;DOM
24304109;24304109-int;177;217;40;25/02/2021;202104;60;DOM
24304111;24304111-int;107;140;33;25/02/2021;202104;60;DOM
24304112;24304112-int;22;31;9;25/02/2021;202104;60;DOM
24305002;24305002-int;110;138;28;25/02/2021;202104;60;DOM
24305003;150303-0084;4918;4961;43;25/02/2021;202104;60;DOM
24305012;24305012-int;231;251;20;25/02/2021;202104;60;DOM
24305015;150303-0083;10868;11162;294;25/02/2021;202104;60;DOM
24305017;150303-0081;6326;6566;240;25/02/2021;202104;60;DOM
24305024;24305024-int;9817;10022;205;25/02/2021;202104;60;PROD
24305025;150303-0100;4859;4912;53;25/02/2021;202104;60;DOM
24305026;24305026-int;3951;3951;0;25/02/2021;202104;60;DOM
24305029;170306-0045;3725;3725;0;25/02/2021;202104;60;PROD
24305030;170306-0044;5201;5336;135;25/02/2021;202104;60;DOM
24305032;24305032-int;346;402;56;25/02/2021;202104;60;DOM
24305033;24305033-int;4128;4366;238;25/02/2021;202104;60;DOM
24305035;24305035-int;115;129;14;25/02/2021;202104;60;DOM
24305036;24305036-int;404;562;158;25/02/2021;202104;60;DOM
24305037;24305037-int;168;168;0;25/02/2021;202104;60;DOM
24305038;24305038-int;70;85;15;25/02/2021;202104;60;DOM
24305039;24305039-int;118;143;25;25/02/2021;202104;60;DOM
24305040;24305040-int;41;51;10;25/02/2021;202104;60;DOM
24305041;24305041-int;142;166;24;25/02/2021;202104;60;DOM
24305042;24305042-int;64;88;24;25/02/2021;202104;60;DOM
24305043;24305043-int;242;257;15;25/02/2021;202104;60;DOM
24305044;24305044-int;195;222;27;25/02/2021;202104;60;DOM
24305045;24305045-int;1692;1978;286;25/02/2021;202104;60;DOM
24305046;24305046-int;131;145;14;25/02/2021;202104;60;DOM
24305047;24305047-int;69;79;10;25/02/2021;202104;60;DOM
24305048;24305048-int;65;73;8;25/02/2021;202104;60;DOM
24305049;37219573377-1;2;2;0;25/02/2021;202104;60;DOM
24305051;24305051-int;15;20;5;25/02/2021;202104;60;DOM
24305052;24305052-int;638;805;167;25/02/2021;202104;60;DOM
24305054;24305054-int;111;133;22;25/02/2021;202104;60;DOM
24305055;24305055-int;519;659;140;25/02/2021;202104;60;DOM
24305056;24305056-int;138;163;25;25/02/2021;202104;60;DOM
24305057;1M05201501495;17;28;11;25/02/2021;202104;60;DOM
24305059;24305059-int;22;29;7;25/02/2021;202104;60;DOM
24305060;24305060-int;142;162;20;25/02/2021;202104;60;DOM
24305061;24305061-int;149;178;29;25/02/2021;202104;60;DOM
24305063;37219573401-9;5;10;5;25/02/2021;202104;60;DOM
24305064;24305064-int;3;9;6;25/02/2021;202104;60;DOM
24305065;24305065-int;122;142;20;25/02/2021;202104;60;DOM
24305066;24305066-int;108;130;22;25/02/2021;202104;60;DOM
24305067;24305067-int;64;77;13;25/02/2021;202104;60;DOM
24305068;24305068-int;142;165;23;25/02/2021;202104;60;DOM
24305069;24305069-int;1838;1959;121;25/02/2021;202104;60;DOM
24305071;24305071-int;223;269;46;25/02/2021;202104;60;DOM
24305072;24305072-int;339;367;28;25/02/2021;202104;60;DOM
24305079;37219573427-4;12;28;16;25/02/2021;202104;60;DOM
24306001;24306001-int;172;181;9;25/02/2021;202104;60;DOM
24306006;150303-0105;4315;4449;134;25/02/2021;202104;60;DOM
24306011;150303-0384;4718;4800;82;25/02/2021;202104;60;DOM
24306014;150303-0283;15975;17059;1084;25/02/2021;202104;60;DOM
24306017;150303-0383;5760;5827;67;25/02/2021;202104;60;DOM
24306019;150303-0258;7371;7437;66;25/02/2021;202104;60;DOM
24306020;150303-0326;4383;4512;129;25/02/2021;202104;60;DOM
24306027;24306027-int;3057;3212;155;25/02/2021;202104;60;DOM
24306029;150303-0327;4560;4717;157;25/02/2021;202104;60;DOM
24306030;150303-0066;1975;2022;47;25/02/2021;202104;60;DOM
24306031;24306031-int;1890;2014;124;25/02/2021;202104;60;DOM
24306034;24306034-int;17030;17242;212;25/02/2021;202104;60;PROD
24306035;24306035-int;3254;3374;120;25/02/2021;202104;60;PROD
24306036;24306036-int;13692;13736;44;25/02/2021;202104;60;PROD
24306041;150303-0329;12832;13127;295;25/02/2021;202104;60;DOM
24306042;150303-0391;1679;1785;106;25/02/2021;202104;60;PROD
24306047;150303-0262;5796;5959;163;25/02/2021;202104;60;PROD
24306048;24306048-int;199146;201562;2416;25/02/2021;202104;60;PROD
24306061;37219564707-0;0;23;23;25/02/2021;202104;60;DOM
24306064;170306-0043;5737;5999;262;25/02/2021;202104;60;DOM
24306070;170809-0140;4357;4524;167;25/02/2021;202104;60;DOM
24306075;170809-0063;4384;4806;422;25/02/2021;202104;60;DOM
24306076;24306076-int;724;969;245;25/02/2021;202104;60;DOM
24306077;24306077-int;194;242;48;25/02/2021;202104;60;DOM
24306078;24306078-int;73;206;133;25/02/2021;202104;60;DOM
24306080;24306080-int;118;130;12;25/02/2021;202104;60;DOM
24306081;24306081-int;105;138;33;25/02/2021;202104;60;DOM
24306082;24306082-int;836;936;100;25/02/2021;202104;60;PROD
24306083;37219575265-6;725;725;0;25/02/2021;202104;60;DOM
24306085;24306085-int;68;81;13;25/02/2021;202104;60;DOM
24306086;37219564962-1;0;170;170;25/02/2021;202104;60;DOM
24306087;37219560440-2;348;412;64;25/02/2021;202104;60;DOM
24306088;37219564814-4;0;43;43;25/02/2021;202104;60;DOM
24306089;37219565951-3;0;17;17;25/02/2021;202104;60;DOM
24306090;37219564780-7;0;43;43;25/02/2021;202104;60;DOM
24307011;170809-0213;1702;1856;154;25/02/2021;202104;60;DOM
24307016;150303-0462;6658;6830;172;25/02/2021;202104;60;DOM
24307018;24307018-int;39;40;1;25/02/2021;202104;60;DOM
24307019;150303-0154;934;955;21;25/02/2021;202104;60;DOM
24307027;170809-0113;2050;2225;175;25/02/2021;202104;60;DOM
24307028;24307028-int;40;49;9;25/02/2021;202104;60;DOM
24307029;24307029-int;70;85;15;25/02/2021;202104;60;DOM
24307030;24307030-int;48;56;8;25/02/2021;202104;60;DOM
24307031;24307031-int;335;384;49;25/02/2021;202104;60;DOM
24307032;24307032-int;113;129;16;25/02/2021;202104;60;DOM
24307033;24307033-int;41;50;9;25/02/2021;202104;60;DOM
24307034;24307034-int;37;47;10;25/02/2021;202104;60;DOM
24307035;24307035-int;79;92;13;25/02/2021;202104;60;DOM
24307036;24307036-int;127;150;23;25/02/2021;202104;60;DOM
24308004;150303-0322;6115;6189;74;25/02/2021;202104;60;DOM
24308006;24308006-int;199;233;34;25/02/2021;202104;60;DOM
24308011;24308011-int;36;46;10;25/02/2021;202104;60;DOM
24308012;150303-0487;8569;8946;377;25/02/2021;202104;60;DOM
24308016;150303-0389;5183;5276;93;25/02/2021;202104;60;DOM
24308020;150303-0251;8541;8541;0;25/02/2021;202104;60;DOM
24308022;150303-0257;4403;4587;184;25/02/2021;202104;60;DOM
24308024;24308024-int;13995;14252;257;25/02/2021;202104;60;PROD
24308025;150303-0387;10526;10526;0;25/02/2021;202104;60;PROD
24308027;24308027-int;15857;15913;56;25/02/2021;202104;60;PROD
24308028;150303-0321;790;976;186;25/02/2021;202104;60;DOM
24308029;150303-0431;10959;11454;495;25/02/2021;202104;60;DOM
24308031;24308031-int;837;911;74;25/02/2021;202104;60;DOM
24308034;24308034-int;172;192;20;25/02/2021;202104;60;DOM
24308035;1780809-0381;1596;1706;110;25/02/2021;202104;60;DOM
24308036;24308036-int;3204;3442;238;25/02/2021;202104;60;DOM
24308040;24308040-int;57;69;12;25/02/2021;202104;60;DOM
24308041;24308041-int;113;129;16;25/02/2021;202104;60;DOM
24308042;24308042-int;10;51;41;25/02/2021;202104;60;DOM
24308043;24308043-int;138;162;24;25/02/2021;202104;60;DOM
24308044;24308044-int;292;424;132;25/02/2021;202104;60;DOM
24308045;24308045-int;379;414;35;25/02/2021;202104;60;DOM
24308046;24308046-int;51;63;12;25/02/2021;202104;60;DOM
24308048;24308048-int;1094;1236;142;25/02/2021;202104;60;DOM
24308049;24308049-int;189;220;31;25/02/2021;202104;60;DOM
24308050;24308050-int;793;1013;220;25/02/2021;202104;60;DOM
24308051;37219571637-0;5;38;33;25/02/2021;202104;60;DOM
24308055;37219573211-2;35;58;23;25/02/2021;202104;60;DOM
24308056;37219573179-1;4;6;2;25/02/2021;202104;60;DOM
24308059;37219573278-1;17;32;15;25/02/2021;202104;60;DOM
24308060;37219573412-1;24;58;34;25/02/2021;202104;60;DOM
24308062;37219573393-8;3;57;54;25/02/2021;202104;60;DOM
24308063;37219569086-4;25;50;25;25/02/2021;202104;60;DOM
24308065;37219571702-2;58;96;38;25/02/2021;202104;60;DOM
24309001;24309001-int;2851;2942;91;25/02/2021;202104;60;DOM
24309002;24309002-int;1737;1756;19;25/02/2021;202104;60;DOM
24309003;24309003-int;5821;6000;179;25/02/2021;202104;60;PROD
24309004;24309004-int;233;275;42;25/02/2021;202104;60;DOM
24309005;24309005-int;33;45;12;25/02/2021;202104;60;DOM
24309008;24309008-int;28;36;8;25/02/2021;202104;60;DOM
24309011;24309011-int;117;136;19;25/02/2021;202104;60;DOM
24309013;24309013-int;174;197;23;25/02/2021;202104;60;DOM
24309014;24309014-int;298;367;69;25/02/2021;202104;60;DOM
24309016;24309016-int;276;322;46;25/02/2021;202104;60;DOM
24309017;24309017-int;74;87;13;25/02/2021;202104;60;DOM
24309019;24309019-int;49;59;10;25/02/2021;202104;60;DOM
24309020;24309020-int;258;316;58;25/02/2021;202104;60;DOM
24309021;24309021-int;2275;2435;160;25/02/2021;202104;60;DOM
24309022;24309022-int;172;184;12;25/02/2021;202104;60;DOM
24309024;24309024-int;28;34;6;25/02/2021;202104;60;DOM
24309026;24309026-int;66;80;14;25/02/2021;202104;60;DOM
24309027;24309027-int;243;257;14;25/02/2021;202104;60;DOM
24309028;24309028-int;1481;1783;302;25/02/2021;202104;60;DOM
24309029;24309029-int;720;737;17;25/02/2021;202104;60;DOM
24309031;24309031-int;379;399;20;25/02/2021;202104;60;DOM
24309032;24309032-int;55;63;8;25/02/2021;202104;60;DOM
24309033;24309033-int;132;156;24;25/02/2021;202104;60;DOM
24309035;24309035-int;2578;2810;232;25/02/2021;202104;60;DOM
24309036;24309036-int;22;38;16;25/02/2021;202104;60;DOM
24309038;24309038-int;2961;2961;0;25/02/2021;202104;60;DOM
24309039;24309039-int;1073;1251;178;25/02/2021;202104;60;DOM
24309040;24309040-int;42;49;7;25/02/2021;202104;60;DOM
24309041;24309041-int;197;238;41;25/02/2021;202104;60;DOM
24309042;24309042-int;51;70;19;25/02/2021;202104;60;DOM
24309043;24309043-int;178;209;31;25/02/2021;202104;60;DOM
24309044;24309044-int;1658;2006;348;25/02/2021;202104;60;DOM
24309045;24309045-int;248;445;197;25/02/2021;202104;60;DOM
24309046;24309046-int;100;113;13;25/02/2021;202104;60;DOM
24309048;24309048-int;1810;2032;222;25/02/2021;202104;60;DOM
24309050;24309050-int;460;490;30;25/02/2021;202104;60;DOM
24309051;24309051-int;1972;2369;397;25/02/2021;202104;60;DOM
24309052;24309052-int;27;40;13;25/02/2021;202104;60;DOM
24309053;24309053-int;312;371;59;25/02/2021;202104;60;DOM
24309054;24309054-int;779;1018;239;25/02/2021;202104;60;DOM
24309055;24309055-int;41;43;2;25/02/2021;202104;60;DOM
24309056;24309056-int;1070;1337;267;25/02/2021;202104;60;DOM
24309057;24309057-int;570;638;68;25/02/2021;202104;60;DOM
24309058;24309058-int;507;578;71;25/02/2021;202104;60;DOM
24309059;24309059-int;1651;1711;60;25/02/2021;202104;60;DOM
24309060;24309060-int;435;477;42;25/02/2021;202104;60;DOM
24309065;24309065-int;106;109;3;25/02/2021;202104;60;DOM
24309066;24309066-int;104;115;11;25/02/2021;202104;60;DOM
24309067;24309067-int;511;588;77;25/02/2021;202104;60;DOM
24309069;24309069-int;3024;3420;396;25/02/2021;202104;60;DOM
24309070;24309070-int;86;122;36;25/02/2021;202104;60;DOM
24309071;24309071-int;1040;1320;280;25/02/2021;202104;60;DOM
24309072;24309072-int;105;144;39;25/02/2021;202104;60;DOM
24309074;24309074-int;6150;6897;747;25/02/2021;202104;60;PROD
24309075;24309075-int;6002;6390;388;25/02/2021;202104;60;DOM
24309076;24309076-int;160;210;50;25/02/2021;202104;60;DOM
24309077;24309077-int;42;73;31;25/02/2021;202104;60;DOM
24309078;24309078-int;100;288;188;25/02/2021;202104;60;PROD
24309079;24309079-int;23;29;6;25/02/2021;202104;60;DOM
24309084;37219575562-6;198;246;48;25/02/2021;202104;60;PROD
24329037;24329037-int;13525;13644;119;25/02/2021;202104;60;PROD
24329038;24329038-int;12168;12594;426;25/02/2021;202104;60;PROD
24329041;24329041-int;2600;2807;207;25/02/2021;202104;60;DOM
24329043;24329043-int;222;244;22;25/02/2021;202104;60;DOM
24329050;37219575646-7;9;21;12;25/02/2021;202104;60;DOM
24329051;24329051-int;65;87;22;25/02/2021;202104;60;DOM
24329054;37219575536-4;8;12;4;25/02/2021;202104;60;DOM
24329057;24329057-int;28;39;11;25/02/2021;202104;60;DOM
24329059;24329059-int;38;44;6;25/02/2021;202104;60;DOM
24329061;37219575604-6;18;26;8;25/02/2021;202104;60;DOM
24329062;24329062-int;182;299;117;25/02/2021;202104;60;DOM
24329065;24329065-int;38;58;20;25/02/2021;202104;60;DOM
24329066;24329066-int;328;376;48;25/02/2021;202104;60;DOM
24329067;37219563758-4;167;200;33;25/02/2021;202104;60;DOM
24329072;24329072-int;34;48;14;25/02/2021;202104;60;DOM
24329074;24329074-int;135;157;22;25/02/2021;202104;60;DOM
24329076;24329076-int;21;34;13;25/02/2021;202104;60;DOM
24329082;24329082-int;370;677;307;25/02/2021;202104;60;DOM
24329088;170809-0324;1508;1556;48;25/02/2021;202104;60;DOM
24329089;37219575679-8;31;40;9;25/02/2021;202104;60;DOM
24329091;24329091-int;2717;2930;213;25/02/2021;202104;60;DOM
24329092;24329092-int;6432;6463;31;25/02/2021;202104;60;PROD
24329094;24329094-int;2635;2983;348;25/02/2021;202104;60;DOM
24329096;170809-0377;2389;2459;70;25/02/2021;202104;60;DOM
24329098;24329098-int;4065;4223;158;25/02/2021;202104;60;DOM
24329099;170809-0378;2311;2347;36;25/02/2021;202104;60;DOM
24329100;170809-0376;6793;6971;178;25/02/2021;202104;60;DOM
24329101;24329101-int;4129;4301;172;25/02/2021;202104;60;DOM
24329102;24329102-int;3794;3969;175;25/02/2021;202104;60;DOM
24329103;24329103-int;1941;1973;32;25/02/2021;202104;60;DOM
24329104;150303-0101;6394;6394;0;25/02/2021;202104;60;PROD
24329105;170809-0286;4422;4517;95;25/02/2021;202104;60;DOM
24329107;24329107-int;2340;2466;126;25/02/2021;202104;60;DOM
24329108;24329108-int;525;589;64;25/02/2021;202104;60;PROD
24329110;24329110-int;455;522;67;25/02/2021;202104;60;DOM
24329111;24329111-int;138;161;23;25/02/2021;202104;60;DOM
24329112;24329112-int;286;298;12;25/02/2021;202104;60;DOM
24329113;24329113-int;1176;1281;105;25/02/2021;202104;60;DOM
24329115;24329115-int;50;57;7;25/02/2021;202104;60;DOM
24340001;24340001-int;1221;1272;51;25/02/2021;202104;60;DOM
24340002;24340002-int;46;49;3;25/02/2021;202104;60;DOM
24340006;24340006-int;382;423;41;25/02/2021;202104;60;DOM
24340007;24340007-int;146;160;14;25/02/2021;202104;60;DOM
24340010;24340010-int;159;180;21;25/02/2021;202104;60;DOM
24340014;24340014-int;114;118;4;25/02/2021;202104;60;DOM
24340015;24340015-int;76;84;8;25/02/2021;202104;60;DOM
24340017;24340017-int;142;156;14;25/02/2021;202104;60;DOM
24340019;24340019-int;245;256;11;25/02/2021;202104;60;DOM
24340023;24340023-int;141;149;8;25/02/2021;202104;60;DOM
24340024;24340024-int;2451;2521;70;25/02/2021;202104;60;DOM
24340026;24340026-int;5;12;7;25/02/2021;202104;60;DOM
24340027;24340027-int;118;138;20;25/02/2021;202104;60;DOM
24340029;24340029-int;2559;2800;241;25/02/2021;202104;60;DOM
24340030;24340030-int;142;162;20;25/02/2021;202104;60;DOM
24340031;24340031-int;1576;1651;75;25/02/2021;202104;60;DOM
24340032;24340032-int;200;217;17;25/02/2021;202104;60;DOM
24340033;24340033-int;1070;1126;56;25/02/2021;202104;60;DOM
24340034;24340034-int;54;59;5;25/02/2021;202104;60;DOM
24340035;24340035-int;3948;4152;204;25/02/2021;202104;60;PROD
24340036;24340036-int;809;911;102;25/02/2021;202104;60;DOM
24340037;24340037-int;70;144;74;25/02/2021;202104;60;DOM
24340038;24340038-int;28;36;8;25/02/2021;202104;60;DOM
24340039;24340039-int;36;44;8;25/02/2021;202104;60;DOM
24340040;24340040-int;2635;2941;306;25/02/2021;202104;60;DOM
24340041;24340041-int;35;58;23;25/02/2021;202104;60;DOM
24340042;37219575380-3;665;665;0;25/02/2021;202104;60;PROD
24341001;24341001-int;2267;2324;57;25/02/2021;202104;60;DOM
24341003;24341003-int;2817;3049;232;25/02/2021;202104;60;DOM
24341004;24341004-int;105198;112909;7711;25/02/2021;202104;60;PROD
24341005;24341005-int;1273;1425;152;25/02/2021;202104;60;DOM
24341007;24341007-int;249;287;38;25/02/2021;202104;60;DOM
24341008;24341008-int;975;1100;125;25/02/2021;202104;60;DOM
24341009;24341009-int;663;792;129;25/02/2021;202104;60;DOM
24341010;24341010-int;370;427;57;25/02/2021;202104;60;DOM
24341011;24341011-int;512;521;9;25/02/2021;202104;60;DOM
24341012;24341012-int;130;155;25;25/02/2021;202104;60;DOM
24341013;24341013-int;98;137;39;25/02/2021;202104;60;DOM
24341014;24341014-int;301;537;236;25/02/2021;202104;60;DOM
24341015;24341015-int;42;51;9;25/02/2021;202104;60;DOM
24341016;24341016-int;116;129;13;25/02/2021;202104;60;DOM
24341018;24341018-int;898;1177;279;25/02/2021;202104;60;DOM
24341019;24341019-int;100;104;4;25/02/2021;202104;60;DOM
24341020;24341020-int;1192;1351;159;25/02/2021;202104;60;DOM
24341021;24341021-int;1258;1335;77;25/02/2021;202104;60;DOM
24341022;24341022-int;1228;1235;7;25/02/2021;202104;60;DOM
24341023;24341023-int;2012;2301;289;25/02/2021;202104;60;DOM
24341024;24341024-int;651;754;103;25/02/2021;202104;60;DOM
24341025;24341025-int;219;552;333;25/02/2021;202104;60;DOM
24341026;24341026-int;985;1009;24;25/02/2021;202104;60;DOM
24341027;24341027-int;1871;2063;192;25/02/2021;202104;60;DOM
24341028;24341028-int;53;105;52;25/02/2021;202104;60;DOM
24341029;24341029-int;99;114;15;25/02/2021;202104;60;DOM
24341030;24341030-int;4700;5485;785;25/02/2021;202104;60;DOM
24341031;24341031-int;1556;1762;206;25/02/2021;202104;60;DOM
24341032;24341032-int;46;61;15;25/02/2021;202104;60;DOM
24341033;24341033-int;15;17;2;25/02/2021;202104;60;DOM
24341034;24341034-int;29;30;1;25/02/2021;202104;60;DOM
24341035;24341035-int;1422;1657;235;25/02/2021;202104;60;DOM
24341036;24341036-int;889;925;36;25/02/2021;202104;60;DOM
24341038;24341038-int;43;50;7;25/02/2021;202104;60;DOM
24341039;24341039-int;484;591;107;25/02/2021;202104;60;DOM
24341040;24341040-int;1548;1597;49;25/02/2021;202104;60;DOM
24341041;24341041-int;563;673;110;25/02/2021;202104;60;DOM
24341042;24341042-int;32;35;3;25/02/2021;202104;60;DOM
24341044;24341044-int;342;393;51;25/02/2021;202104;60;DOM
24341045;24341045-int;1194;1251;57;25/02/2021;202104;60;DOM
24341046;24341046-int;6905;7000;95;25/02/2021;202104;60;PROD
24341047;24341047-int;4702;4858;156;25/02/2021;202104;60;PROD
24341048;24341048-int;137;166;29;25/02/2021;202104;60;DOM
24341049;24341049-int;1556;1850;294;25/02/2021;202104;60;DOM
24341050;24341050-int;1484;1803;319;25/02/2021;202104;60;DOM
24341051;24341051-int;200;232;32;25/02/2021;202104;60;DOM
24341052;24341052-int;687;981;294;25/02/2021;202104;60;DOM
24341053;24341053-int;4330;4955;625;25/02/2021;202104;60;DOM
24341054;24341054-int;186;219;33;25/02/2021;202104;60;DOM
24341055;24341055-int;1651;1967;316;25/02/2021;202104;60;DOM
24341056;24341056-int;125;158;33;25/02/2021;202104;60;DOM
24341059;24341059-int;1092;1310;218;25/02/2021;202104;60;DOM
24341060;24341060-int;19;24;5;25/02/2021;202104;60;DOM
24341061;24341061-int;38;45;7;25/02/2021;202104;60;DOM
24341062;24341062-int;81;89;8;25/02/2021;202104;60;DOM
24341063;24341063-int;205;270;65;25/02/2021;202104;60;DOM
24341065;24341065-int;25;32;7;25/02/2021;202104;60;DOM
24341066;24341066-int;432;470;38;25/02/2021;202104;60;DOM
24341067;24341067-int;41;114;73;25/02/2021;202104;60;DOM
24341068;24341068-int;1051;1276;225;25/02/2021;202104;60;DOM
24341069;24341069-int;181;215;34;25/02/2021;202104;60;DOM
24341070;24341070-int;27;32;5;25/02/2021;202104;60;DOM
24341073;24341073-int;85;117;32;25/02/2021;202104;60;DOM
24341074;24341074-int;282;458;176;25/02/2021;202104;60;DOM
24341076;24341076-int;182;243;61;25/02/2021;202104;60;DOM
24341077;24341077-int;99;226;127;25/02/2021;202104;60;DOM
24341078;24341078-int;140;170;30;25/02/2021;202104;60;DOM
24341079;24341079-int;82;109;27;25/02/2021;202104;60;DOM
24341080;24341080-int;126;160;34;25/02/2021;202104;60;DOM
24341081;24341081-int;25;31;6;25/02/2021;202104;60;DOM
24341082;24341082-int;321;417;96;25/02/2021;202104;60;DOM
24341083;24341083-int;53;92;39;25/02/2021;202104;60;DOM
24341085;24341085-int;40;53;13;25/02/2021;202104;60;DOM
24341086;24341086-int;1358;1396;38;25/02/2021;202104;60;PROD
24341087;24341087-int;138;158;20;25/02/2021;202104;60;DOM
24341089;24341089-int;73;94;21;25/02/2021;202104;60;DOM
24341090;24341090-int;16;18;2;25/02/2021;202104;60;DOM
24341091;24341091-int;313;638;325;25/02/2021;202104;60;DOM
24341093;37219562750-2;28;53;25;25/02/2021;202104;60;DOM
24341094;24341094-int;95;108;13;25/02/2021;202104;60;DOM
24341095;24341095-int;129;154;25;25/02/2021;202104;60;DOM
24341096;24341096-int;248;248;0;25/02/2021;202104;60;DOM
24341097;24341097-int;42;53;11;25/02/2021;202104;60;DOM
24341098;37219576024-6;26;39;13;25/02/2021;202104;60;DOM
24341099;37219575620-2;170;249;79;25/02/2021;202104;60;DOM
24341100;37219575687-1;40;58;18;25/02/2021;202104;60;DOM
24341101;37219564566-0;25;31;6;25/02/2021;202104;60;DOM
24341102;37219576693-8;121;197;76;25/02/2021;202104;60;DOM
24341103;37219565001-7;31;42;11;25/02/2021;202104;60;DOM
24341105;37319575570-9;155;202;47;25/02/2021;202104;60;DOM
24341106;37219572908-4;278;498;220;25/02/2021;202104;60;DOM
24341107;37219572916-7;130;168;38;25/02/2021;202104;60;DOM
24341108;37219572981-1;602;636;34;25/02/2021;202104;60;PROD
24341109;37219575638-4;28;32;4;25/02/2021;202104;60;DOM
24341110;37219575281-3;38;43;5;25/02/2021;202104;60;PROD
24342002;24342002-int;9356;9396;40;25/02/2021;202104;60;PROD
24342003;24342003-int;85;115;30;25/02/2021;202104;60;DOM
24342005;24342005-int;5;9;4;25/02/2021;202104;60;DOM
24342007;24342007-int;3512;3739;227;25/02/2021;202104;60;DOM
24342008;24342008-int;334;378;44;25/02/2021;202104;60;DOM
24342009;24342009-int;2235;2374;139;25/02/2021;202104;60;DOM
24342010;24342010-int;118;137;19;25/02/2021;202104;60;DOM
24342012;24342012-int;101;131;30;25/02/2021;202104;60;DOM
24342013;24342013-int;21;27;6;25/02/2021;202104;60;DOM
24342014;24342014-int;24;27;3;25/02/2021;202104;60;DOM
24342015;24342015-int;3419;3721;302;25/02/2021;202104;60;DOM
24342016;24342016-int;69;88;19;25/02/2021;202104;60;DOM
24342017;24342017-int;172;200;28;25/02/2021;202104;60;DOM
24342020;24342020-int;1974;2191;217;25/02/2021;202104;60;DOM
24342021;24342021-int;532;590;58;25/02/2021;202104;60;DOM
24342023;24342023-int;695;806;111;25/02/2021;202104;60;DOM
24342024;24342024-int;457;516;59;25/02/2021;202104;60;DOM
24342025;24342025-int;62;69;7;25/02/2021;202104;60;DOM
24342026;24342026-int;854;1029;175;25/02/2021;202104;60;DOM
24342027;24342027-int;1652;1717;65;25/02/2021;202104;60;DOM
24342028;24342028-int;65;74;9;25/02/2021;202104;60;DOM
24342029;24342029-int;457;545;88;25/02/2021;202104;60;DOM
24342030;24342030-int;3111;3528;417;25/02/2021;202104;60;DOM
24342031;24342031-int;2185;2407;222;25/02/2021;202104;60;DOM
24342032;24342032-int;359;410;51;25/02/2021;202104;60;DOM
24342033;24342033-int;779;929;150;25/02/2021;202104;60;DOM
24342034;24342034-int;206;235;29;25/02/2021;202104;60;DOM
24342035;24342035-int;319;360;41;25/02/2021;202104;60;DOM
24342036;24342036-int;221;234;13;25/02/2021;202104;60;DOM
24342038;24342038-int;153;174;21;25/02/2021;202104;60;DOM
24342039;24342039-int;196;222;26;25/02/2021;202104;60;DOM
24342040;24342040-int;2154;2191;37;25/02/2021;202104;60;PROD
24342041;24342041-int;50;60;10;25/02/2021;202104;60;DOM
24342042;24342042-int;103;113;10;25/02/2021;202104;60;DOM
24342043;37219564616-3;0;23;23;25/02/2021;202104;60;DOM
24342045;24342045-int;68;78;10;25/02/2021;202104;60;DOM
24342046;24342046-int;188;212;24;25/02/2021;202104;60;DOM
24342047;24342047-int;93;112;19;25/02/2021;202104;60;DOM
24342048;24342048-int;62;193;131;25/02/2021;202104;60;DOM
24342049;24342049-int;276;323;47;25/02/2021;202104;60;DOM
24342050;24342050-int;53;68;15;25/02/2021;202104;60;DOM
24342051;24342051-int;919;1059;140;25/02/2021;202104;60;DOM
24342052;24342052-int;206;246;40;25/02/2021;202104;60;DOM
24342053;24342053-int;66;73;7;25/02/2021;202104;60;DOM
24342054;24342054-int;296;541;245;25/02/2021;202104;60;DOM
24342055;24342055-int;80;94;14;25/02/2021;202104;60;DOM
24342058;24342058-int;167;238;71;25/02/2021;202104;60;DOM
24342059;24342059-int;133;148;15;25/02/2021;202104;60;DOM
24342060;24342060-int;190;228;38;25/02/2021;202104;60;DOM
24342061;24342061-int;23;24;1;25/02/2021;202104;60;DOM
24342063;24342063-int;42;54;12;25/02/2021;202104;60;DOM
24342064;24342064-int;695;745;50;25/02/2021;202104;60;DOM
24342065;37219564673-4;0;3;3;25/02/2021;202104;60;DOM
24342066;24342066-int;68;74;6;25/02/2021;202104;60;DOM
24342067;24342067-int;114;125;11;25/02/2021;202104;60;DOM
24342068;24342068-int;87;98;11;25/02/2021;202104;60;DOM
24342069;24342069-int;39;43;4;25/02/2021;202104;60;DOM
24342070;24342070-int;54;64;10;25/02/2021;202104;60;DOM
24342071;24342071-int;98;110;12;25/02/2021;202104;60;DOM
24342072;24342072-int;50;68;18;25/02/2021;202104;60;DOM
24342073;24342073-int;183;194;11;25/02/2021;202104;60;DOM
24342076;24342076-int;23;26;3;25/02/2021;202104;60;DOM
24342077;24342077-int;29;35;6;25/02/2021;202104;60;DOM
24342078;24342078-int;521;540;19;25/02/2021;202104;60;DOM
24342079;24342079-int;396;530;134;25/02/2021;202104;60;DOM
24342080;24342080-int;201;227;26;25/02/2021;202104;60;DOM
24342081;24342081-int;4859;4859;0;25/02/2021;202104;60;PROD
24342082;24342082-int;636;794;158;25/02/2021;202104;60;DOM
24342083;24342083-int;144;169;25;25/02/2021;202104;60;DOM
24342084;24342084-int;366;443;77;25/02/2021;202104;60;DOM
24342085;24342085-int;150;191;41;25/02/2021;202104;60;DOM
24342086;24342086-int;29;33;4;25/02/2021;202104;60;DOM
24342087;24342087-int;111;127;16;25/02/2021;202104;60;DOM
24342088;24342088-int;2386;2684;298;25/02/2021;202104;60;DOM
24342089;24342089-int;110;110;0;25/02/2021;202104;60;DOM
24342090;24342090-int;63;72;9;25/02/2021;202104;60;DOM
24342091;24342091-int;2586;2688;102;25/02/2021;202104;60;DOM
24342092;24342092-int;1244;1420;176;25/02/2021;202104;60;DOM
24342093;24342093-int;1539;1637;98;25/02/2021;202104;60;DOM
24342095;24342095-int;49;62;13;25/02/2021;202104;60;DOM
24342097;24342097-int;11;16;5;25/02/2021;202104;60;DOM
24342098;24342098-int;4;5;1;25/02/2021;202104;60;DOM
24342099;24342099-int;75;93;18;25/02/2021;202104;60;DOM
24342100;24342100-int;18;23;5;25/02/2021;202104;60;DOM
24342101;24342101-int;103;115;12;25/02/2021;202104;60;DOM
24342102;24342102-int;401;443;42;25/02/2021;202104;60;DOM
24342103;24342103-int;147;170;23;25/02/2021;202104;60;DOM
24342104;24342104-int;40;49;9;25/02/2021;202104;60;DOM
24342105;24342105-int;785;1180;395;25/02/2021;202104;60;PROD
24342106;24342106-int;0;9;9;25/02/2021;202104;60;DOM
24342108;24342108-int;13;16;3;25/02/2021;202104;60;DOM
24342109;24342109-int;239;287;48;25/02/2021;202104;60;DOM
24342110;24342110-int;205;225;20;25/02/2021;202104;60;DOM
24342111;24342111-int;12;17;5;25/02/2021;202104;60;DOM
24342113;24342113-int;11;20;9;25/02/2021;202104;60;DOM
24342114;24342114-int;240;307;67;25/02/2021;202104;60;DOM
24342115;24342115-int;5;6;1;25/02/2021;202104;60;DOM
24342116;24342116-int;602;602;0;25/02/2021;202104;60;PROD
24342118;24342118-int;0;0;0;25/02/2021;202104;60;DOM
24342120;24342120-int;825;825;0;25/02/2021;202104;60;PROD
24342121;24342121-int;5865;6319;454;25/02/2021;202104;60;DOM
24342122;24342122-int;46;57;11;25/02/2021;202104;60;DOM
24342123;24342123-int;18;18;0;25/02/2021;202104;60;DOM
24343002;170809-0208;3761;3999;238;25/02/2021;202104;60;DOM
24343009;170809-0165;4845;5356;511;25/02/2021;202104;60;DOM
24343012;24343012-int;135;167;32;25/02/2021;202104;60;DOM
24343015;170809-0265;6982;7275;293;25/02/2021;202104;60;DOM
24343016;170809-0004;5325;5458;133;25/02/2021;202104;60;PROD
24343017;170809-0010;3280;3288;8;25/02/2021;202104;60;PROD
24343018;170809-0058;5005;5108;103;25/02/2021;202104;60;PROD
24343022;24343022-int;2329;2602;273;25/02/2021;202104;60;DOM
24343023;170809-0261;5327;5479;152;25/02/2021;202104;60;DOM
24343025;170809-0008;7322;7720;398;25/02/2021;202104;60;DOM
24343026;150303-0142;683;683;0;25/02/2021;202104;60;DOM
24343027;150303-0065;8073;8466;393;25/02/2021;202104;60;DOM
24343028;150303-0073;4269;4452;183;25/02/2021;202104;60;DOM
24343030;37219579663-8;6;7;1;25/02/2021;202104;60;DOM
24343033;24343033-int;2020;2187;167;25/02/2021;202104;60;DOM
24343034;170809-0103;9830;10566;736;25/02/2021;202104;60;DOM
24343040;170809-0355;2359;2589;230;25/02/2021;202104;60;DOM
24343041;170809-0210;2256;2300;44;25/02/2021;202104;60;PROD
24343042;24343042-int;19725;19725;0;25/02/2021;202104;60;PROD
24343043;24343043-int;866;901;35;25/02/2021;202104;60;DOM
24343046;170809-0209;3893;4280;387;25/02/2021;202104;60;DOM
24343047;24343047-int;2366;2848;482;25/02/2021;202104;60;DOM
24343048;170809-0219;5562;6050;488;25/02/2021;202104;60;DOM
24343049;170809-0183;2892;3024;132;25/02/2021;202104;60;DOM
24343050;170809-0064;6882;7398;516;25/02/2021;202104;60;DOM
24343051;24343051-int;340;376;36;25/02/2021;202104;60;DOM
24343053;24343053-int;195;222;27;25/02/2021;202104;60;DOM
24343055;24343055-int;173;295;122;25/02/2021;202104;60;DOM
24343056;24343056-int;3;5;2;25/02/2021;202104;60;DOM
24343057;24343057-int;1313;1471;158;25/02/2021;202104;60;DOM
24343058;24343058-int;794;1000;206;25/02/2021;202104;60;DOM
24343059;37219579614-1;36;66;30;25/02/2021;202104;60;DOM
24343060;24343060-int;1477;1717;240;25/02/2021;202104;60;DOM
24343062;37219563329-4;8;14;6;25/02/2021;202104;60;DOM
24343063;24343063-int;73;102;29;25/02/2021;202104;60;DOM
24343064;24343064-int;937;953;16;25/02/2021;202104;60;DOM
24343065;24343065-int;367;683;316;25/02/2021;202104;60;DOM
24343066;24343066-int;918;977;59;25/02/2021;202104;60;DOM
24343067;1M05201300849;1946;2316;370;25/02/2021;202104;60;DOM
24343068;24343068-int;315;350;35;25/02/2021;202104;60;DOM
24343069;24343069-int;155;199;44;25/02/2021;202104;60;DOM
24343071;24343071-int;1068;1335;267;25/02/2021;202104;60;DOM
24343072;24343072-int;1236;1446;210;25/02/2021;202104;60;DOM
24343074;24343074-int;181;208;27;25/02/2021;202104;60;DOM
24343075;24343075-int;217;279;62;25/02/2021;202104;60;DOM
24344001;37219565126-2;217;419;202;25/02/2021;202104;60;DOM
24344002;37219565290-6;24;34;10;25/02/2021;202104;60;DOM
24344003;37219563600-8;77;109;32;25/02/2021;202104;60;DOM
24344004;37219563659-4;74;117;43;25/02/2021;202104;60;DOM
24344005;37219566900-9;11;15;4;25/02/2021;202104;60;DOM
24344006;37219566827-4;31;41;10;25/02/2021;202104;60;DOM
24344007;37219566975-1;37;62;25;25/02/2021;202104;60;DOM
24344008;37219573799-6;261;357;96;25/02/2021;202104;60;DOM
24344009;37219566835-7;61;164;103;25/02/2021;202104;60;DOM
24344010;37219564384-8;26;43;17;25/02/2021;202104;60;DOM
24344011;37219565993-5;97;168;71;25/02/2021;202104;60;DOM
24344012;37219566090-9;627;798;171;25/02/2021;202104;60;DOM
24344013;37219566108-9;44;69;25;25/02/2021;202104;60;DOM
24344015;37219563386-4;5;13;8;25/02/2021;202104;60;DOM
24344016;37219574805-0;20;25;5;25/02/2021;202104;60;DOM
24344017;37219566124-6;1995;2595;600;25/02/2021;202104;60;DOM
24344018;37219573583-4;252;441;189;25/02/2021;202104;60;DOM
24344019;37219573997-6;5;19;14;25/02/2021;202104;60;DOM
24344020;37219574870-4;7;16;9;25/02/2021;202104;60;DOM
24344021;37219565712-9;47;77;30;25/02/2021;202104;60;DOM
24344022;37219565779-8;84;102;18;25/02/2021;202104;60;DOM
24344023;37219565977-8;83;119;36;25/02/2021;202104;60;DOM
24344024;37219565282-3;7;11;4;25/02/2021;202104;60;DOM
24344025;37219565225-2;31;37;6;25/02/2021;202104;60;DOM
24344026;37219574888-6;6;10;4;25/02/2021;202104;60;DOM
24344027;37219565613-9;52;81;29;25/02/2021;202104;60;DOM
24344028;37219564640-3;347;577;230;25/02/2021;202104;60;DOM
24344029;37219563733-7;9;14;5;25/02/2021;202104;60;DOM
24344031;37219565217-9;115;384;269;25/02/2021;202104;60;DOM
24344032;37219574011-5;21;31;10;25/02/2021;202104;60;DOM
24344033;37219565209-6;33;49;16;25/02/2021;202104;60;DOM
24344034;37219573849-9;18;33;15;25/02/2021;202104;60;DOM
24344035;37219563493-8;14;21;7;25/02/2021;202104;60;DOM
24344036;37219574847-2;84;110;26;25/02/2021;202104;60;DOM
24344037;37219566074-3;532;754;222;25/02/2021;202104;60;DOM
24344038;37219563436-7;22;35;13;25/02/2021;202104;60;DOM
24344039;37219574854-8;15;22;7;25/02/2021;202104;60;DOM
24344040;37219574052-9;14;32;18;25/02/2021;202104;60;DOM
24344041;37219574201-2;16;27;11;25/02/2021;202104;60;DOM
24344042;37219573781-4;66;94;28;25/02/2021;202104;60;DOM
24344043;37219566165-9;728;1007;279;25/02/2021;202104;60;DOM
24344044;37219564657-7;82;126;44;25/02/2021;202104;60;DOM
24344045;37219574797-9;73;89;16;25/02/2021;202104;60;DOM
24344046;37219574219-4;383;726;343;25/02/2021;202104;60;DOM
24344047;37219574730-0;54;93;39;25/02/2021;202104;60;DOM
24344049;37219574268-1;320;631;311;25/02/2021;202104;60;DOM
24344050;37219574318-0;13;16;3;25/02/2021;202104;60;DOM
24344051;37219573625-3;61;86;25;25/02/2021;202104;60;DOM
24344052;37219566025-5;330;421;91;25/02/2021;202104;60;DOM
24344053;37219574797-9;38;67;29;25/02/2021;202104;60;DOM
24344054;37219576588-4;31;43;12;25/02/2021;202104;60;DOM
24344055;37219563428-4;6;8;2;25/02/2021;202104;60;DOM
24344056;37219573310-2;30;42;12;25/02/2021;202104;60;DOM
24344057;37219574904-1;25;33;8;25/02/2021;202104;60;DOM
24344058;24344058-int;114;246;132;25/02/2021;202104;60;DOM
24344059;37219563527-3;123;400;277;25/02/2021;202104;60;DOM
24344060;37219573575-0;284;508;224;25/02/2021;202104;60;DOM
24344061;37219565118-9;84;111;27;25/02/2021;202104;60;DOM
24344062;37219575323-3;22;31;9;25/02/2021;202104;60;DOM
24344063;37219540866-7;338;526;188;25/02/2021;202104;60;DOM
24344064;37219574862-1;21;45;24;25/02/2021;202104;60;DOM
24344065;37219573559-4;1050;1795;745;25/02/2021;202104;60;DOM
24344066;37219570340-2;0;0;0;25/02/2021;202104;60;DOM
24344067;37219546453-9;25;25;0;25/02/2021;202104;60;PROD
24344068;37219566082-6;34;47;13;25/02/2021;202104;60;DOM
24344069;37219574896-9;492;757;265;25/02/2021;202104;60;DOM
24344070;37219571140-5;11;18;7;25/02/2021;202104;60;DOM
24344071;37219565894-5;36;50;14;25/02/2021;202104;60;DOM
24344072;37219567668-1;72;105;33;25/02/2021;202104;60;DOM
24344073;37219566934-8;132;180;48;25/02/2021;202104;60;DOM
24344074;37219565332-6;8;10;2;25/02/2021;202104;60;DOM
24344075;37219566949-1;35;49;14;25/02/2021;202104;60;DOM
24344077;37219571611-5;2;3;1;25/02/2021;202104;60;DOM
24344078;37219571652-9;2;5;3;25/02/2021;202104;60;DOM
24344079;37219569730-7;111;335;224;25/02/2021;202104;60;DOM
24344080;37219571546-3;28;52;24;25/02/2021;202104;60;DOM
24344081;37219570704-9;25;25;0;25/02/2021;202104;60;DOM
24344082;37219571603-2;2;2;0;25/02/2021;202104;60;DOM
24344083;37219569110-0;6;12;6;25/02/2021;202104;60;DOM
24344084;37219573195-7;182;400;218;25/02/2021;202104;60;DOM
24344085;37219571045-2;5;8;3;25/02/2021;202104;60;DOM
24344087;37219569557-4;6;115;109;25/02/2021;202104;60;DOM
24344088;37219571694-1;3;6;3;25/02/2021;202104;60;DOM
24344089;37219574276-4;7;29;22;25/02/2021;202104;60;DOM
24344090;37219565340-9;33;73;40;25/02/2021;202104;60;DOM
24344094;37219569714-1;10;17;7;25/02/2021;202104;60;DOM
24344095;37219573229-4;45;62;17;25/02/2021;202104;60;DOM
24344099;37219565324-3;13;19;6;25/02/2021;202104;60;DOM
24344104;14254328165;3215;4083;868;25/02/2021;202104;60;PROD
11001001;11001001-int;0;88;88;25/02/2021;202104;60;DOM
11001002;11001002-int;0;88;88;25/02/2021;202104;60;DOM
11001003;11001003-int;0;24;24;25/02/2021;202104;60;DOM
11001004;11001004-int;0;24;24;25/02/2021;202104;60;DOM
11001005;11001005-int;0;24;24;25/02/2021;202104;60;DOM
11001006;11001006-int;0;24;24;25/02/2021;202104;60;DOM
11001008;11001008-int;0;24;24;25/02/2021;202104;60;DOM
11001010;11001010-int;0;88;88;25/02/2021;202104;60;DOM
11001011;11001011-int;0;88;88;25/02/2021;202104;60;DOM
11001013;11001013-int;0;24;24;25/02/2021;202104;60;DOM
11001014;11001014-int;0;24;24;25/02/2021;202104;60;DOM
11001015;11001015-int;0;24;24;25/02/2021;202104;60;DOM
11001016;11001016-int;0;24;24;25/02/2021;202104;60;DOM
11001017;11001017-int;0;24;24;25/02/2021;202104;60;DOM
11101005;11101005-int;0;24;24;25/02/2021;202104;60;DOM
11101007;11101007-int;0;24;24;25/02/2021;202104;60;DOM
11101008;11101008-int;0;24;24;25/02/2021;202104;60;DOM
11101015;11101015-int;0;24;24;25/02/2021;202104;60;DOM
11101017;11101017-int;0;24;24;25/02/2021;202104;60;DOM
11101020;11101020-int;0;24;24;25/02/2021;202104;60;DOM
11101023;11101023-int;0;44;44;25/02/2021;202104;60;DOM
11102002;11102002-int;0;24;24;25/02/2021;202104;60;DOM
11102006;11102006-int;0;44;44;25/02/2021;202104;60;DOM
11102009;11102009-int;0;24;24;25/02/2021;202104;60;DOM
11102012;11102012-int;0;24;24;25/02/2021;202104;60;DOM
11102018;11102018-int;0;24;24;25/02/2021;202104;60;DOM
11103001;11103001-int;0;24;24;25/02/2021;202104;60;DOM
11103002;11103002-int;0;24;24;25/02/2021;202104;60;DOM
11103003;11103003-int;0;44;44;25/02/2021;202104;60;DOM
11103012;11103012-int;0;24;24;25/02/2021;202104;60;DOM
11103022;11103022-int;0;24;24;25/02/2021;202104;60;DOM
11103023;11103023-int;0;24;24;25/02/2021;202104;60;DOM
11103024;11103024-int;0;24;24;25/02/2021;202104;60;DOM
11107002;11107002-int;0;24;24;25/02/2021;202104;60;DOM
11108014;11108014-int;0;88;88;25/02/2021;202104;60;DOM
11109001;11109001-int;0;24;24;25/02/2021;202104;60;DOM
11110003;11110003-int;0;24;24;25/02/2021;202104;60;DOM
11112001;11112001-int;0;24;24;25/02/2021;202104;60;DOM
11112005;11112005-int;0;24;24;25/02/2021;202104;60;DOM
11112009;11112009-int;0;24;24;25/02/2021;202104;60;DOM
11112012;11112012-int;0;24;24;25/02/2021;202104;60;DOM
11112013;11112013-int;0;24;24;25/02/2021;202104;60;DOM
11112014;11112014-int;0;24;24;25/02/2021;202104;60;DOM
11112015;11112015-int;0;24;24;25/02/2021;202104;60;DOM
11112016;11112016-int;0;24;24;25/02/2021;202104;60;DOM
11112017;11112017-int;0;24;24;25/02/2021;202104;60;DOM
11114001;11114001-int;0;24;24;25/02/2021;202104;60;DOM
11114002;11114002-int;0;44;44;25/02/2021;202104;60;DOM
11117001;11117001-int;0;24;24;25/02/2021;202104;60;DOM
11117002;11117002-int;0;24;24;25/02/2021;202104;60;DOM
11117006;11117006-int;0;24;24;25/02/2021;202104;60;DOM
11117008;11117008-int;0;24;24;25/02/2021;202104;60;DOM
11117009;11117009-int;0;24;24;25/02/2021;202104;60;DOM
11117010;11117010-int;0;24;24;25/02/2021;202104;60;DOM
11117020;11117020-int;0;24;24;25/02/2021;202104;60;DOM
11117021;11117021-int;0;24;24;25/02/2021;202104;60;DOM
11117022;11117022-int;0;24;24;25/02/2021;202104;60;DOM
11117023;11117023-int;0;24;24;25/02/2021;202104;60;DOM
11117024;11117024-int;0;24;24;25/02/2021;202104;60;DOM
11117026;11117026-int;0;24;24;25/02/2021;202104;60;DOM
11117027;11117027-int;0;24;24;25/02/2021;202104;60;DOM
11117028;11117028-int;0;24;24;25/02/2021;202104;60;DOM
11117029;11117029-int;0;24;24;25/02/2021;202104;60;DOM
11117031;11117031-int;0;24;24;25/02/2021;202104;60;DOM
11117033;11117033-int;0;24;24;25/02/2021;202104;60;DOM
11117034;11117034-int;0;24;24;25/02/2021;202104;60;DOM
11117035;11117035-int;0;24;24;25/02/2021;202104;60;DOM
11117036;11117036-int;0;24;24;25/02/2021;202104;60;DOM
11117037;11117037-int;0;24;24;25/02/2021;202104;60;DOM
11117041;11117041-int;0;24;24;25/02/2021;202104;60;DOM
11117044;11117044-int;0;24;24;25/02/2021;202104;60;DOM
11117045;11117045-int;0;24;24;25/02/2021;202104;60;DOM
11117046;11117046-int;0;24;24;25/02/2021;202104;60;DOM
11117047;11117047-int;0;24;24;25/02/2021;202104;60;DOM
11117048;11117048-int;0;24;24;25/02/2021;202104;60;DOM
11119001;11119001-int;0;88;88;25/02/2021;202104;60;DOM
11119002;11119002-int;0;88;88;25/02/2021;202104;60;DOM
11119003;11119003-int;0;88;88;25/02/2021;202104;60;DOM
11119005;11119005-int;0;24;24;25/02/2021;202104;60;DOM
11119006;11119006-int;0;24;24;25/02/2021;202104;60;DOM
11119007;11119007-int;0;24;24;25/02/2021;202104;60;DOM
11119008;11119008-int;0;24;24;25/02/2021;202104;60;DOM
11119009;11119009-int;0;24;24;25/02/2021;202104;60;DOM
11119010;11119010-int;0;24;24;25/02/2021;202104;60;DOM
11119011;11119011-int;0;24;24;25/02/2021;202104;60;DOM
11119014;11119014-int;0;24;24;25/02/2021;202104;60;DOM
11119015;11119015-int;0;24;24;25/02/2021;202104;60;DOM
11119019;11119019-int;0;24;24;25/02/2021;202104;60;DOM
11119020;11119020-int;0;24;24;25/02/2021;202104;60;DOM
11119021;11119021-int;0;24;24;25/02/2021;202104;60;DOM
11119023;11119023-int;0;24;24;25/02/2021;202104;60;DOM
11119024;11119024-int;0;24;24;25/02/2021;202104;60;DOM
11119028;11119028-int;0;24;24;25/02/2021;202104;60;DOM
11119029;11119029-int;0;24;24;25/02/2021;202104;60;DOM
11119031;11119031-int;0;24;24;25/02/2021;202104;60;DOM
11119032;11119032-int;0;24;24;25/02/2021;202104;60;DOM
11119033;11119033-int;0;24;24;25/02/2021;202104;60;DOM
11119034;11119034-int;0;24;24;25/02/2021;202104;60;DOM
11119035;11119035-int;0;24;24;25/02/2021;202104;60;DOM
11119037;11119037-int;0;24;24;25/02/2021;202104;60;DOM
11119038;11119038-int;0;24;24;25/02/2021;202104;60;DOM
11119039;11119039-int;0;24;24;25/02/2021;202104;60;DOM
11123001;11123001-int;0;24;24;25/02/2021;202104;60;DOM
11123004;11123004-int;0;24;24;25/02/2021;202104;60;DOM
11123007;11123007-int;0;24;24;25/02/2021;202104;60;DOM
11123009;11123009-int;0;24;24;25/02/2021;202104;60;DOM
11123010;11123010-int;0;24;24;25/02/2021;202104;60;DOM
11123011;11123011-int;0;24;24;25/02/2021;202104;60;DOM
11124002;11124002-int;0;24;24;25/02/2021;202104;60;DOM
11124003;11124003-int;0;24;24;25/02/2021;202104;60;DOM
11124004;11124004-int;0;24;24;25/02/2021;202104;60;DOM
11124006;11124006-int;0;24;24;25/02/2021;202104;60;DOM
11124007;11124007-int;0;24;24;25/02/2021;202104;60;DOM
11124008;11124008-int;0;24;24;25/02/2021;202104;60;DOM
11124010;11124010-int;0;24;24;25/02/2021;202104;60;DOM
11124011;11124011-int;0;24;24;25/02/2021;202104;60;DOM
11124012;11124012-int;0;24;24;25/02/2021;202104;60;DOM
11124016;11124016-int;0;88;88;25/02/2021;202104;60;DOM
11124017;11124017-int;0;24;24;25/02/2021;202104;60;DOM
11124018;11124018-int;0;24;24;25/02/2021;202104;60;DOM
11124019;11124019-int;0;24;24;25/02/2021;202104;60;DOM
11124021;11124021-int;0;24;24;25/02/2021;202104;60;DOM
11124022;11124022-int;0;24;24;25/02/2021;202104;60;DOM
11124023;11124023-int;0;24;24;25/02/2021;202104;60;DOM
11124024;11124024-int;0;24;24;25/02/2021;202104;60;DOM
11124025;11124025-int;0;24;24;25/02/2021;202104;60;DOM
11124028;11124028-int;0;24;24;25/02/2021;202104;60;DOM
11124029;11124029-int;0;24;24;25/02/2021;202104;60;DOM
11124046;11124046-int;0;24;24;25/02/2021;202104;60;DOM
11124053;11124053-int;0;44;44;25/02/2021;202104;60;DOM
11124055;11124055-int;0;24;24;25/02/2021;202104;60;DOM
11124056;11124056-int;0;24;24;25/02/2021;202104;60;DOM
11124060;11124060-int;0;24;24;25/02/2021;202104;60;DOM
11124061;11124061-int;0;24;24;25/02/2021;202104;60;DOM
11124062;11124062-int;0;24;24;25/02/2021;202104;60;DOM
11124071;11124071-int;0;44;44;25/02/2021;202104;60;DOM
11124072;11124072-int;0;44;44;25/02/2021;202104;60;DOM
11124073;11124073-int;0;44;44;25/02/2021;202104;60;DOM
11124074;11124074-int;0;88;88;25/02/2021;202104;60;DOM
11124075;11124075-int;0;24;24;25/02/2021;202104;60;DOM
11124077;11124077-int;0;24;24;25/02/2021;202104;60;DOM
11124079;11124079-int;0;88;88;25/02/2021;202104;60;DOM
11124081;11124081-int;0;88;88;25/02/2021;202104;60;DOM
11124082;11124082-int;0;24;24;25/02/2021;202104;60;DOM
11124083;11124083-int;0;24;24;25/02/2021;202104;60;DOM
11124086;11124086-int;0;24;24;25/02/2021;202104;60;DOM
11124087;11124087-int;0;24;24;25/02/2021;202104;60;DOM
11124090;11124090-int;0;24;24;25/02/2021;202104;60;DOM
11124092;11124092-int;0;24;24;25/02/2021;202104;60;DOM
11201012;11201012-int;0;24;24;25/02/2021;202104;60;DOM
11201013;11201013-int;0;24;24;25/02/2021;202104;60;DOM
11201014;11201014-int;0;24;24;25/02/2021;202104;60;DOM
11201015;11201015-int;0;24;24;25/02/2021;202104;60;DOM
11201016;11201016-int;0;24;24;25/02/2021;202104;60;DOM
11201017;11201017-int;0;24;24;25/02/2021;202104;60;DOM
11201018;11201018-int;0;24;24;25/02/2021;202104;60;DOM
11201019;11201019-int;0;24;24;25/02/2021;202104;60;DOM
11201020;11201020-int;0;24;24;25/02/2021;202104;60;DOM
11201023;11201023-int;0;24;24;25/02/2021;202104;60;DOM
11201024;11201024-int;0;24;24;25/02/2021;202104;60;DOM
11201025;11201025-int;0;24;24;25/02/2021;202104;60;DOM
11201026;11201026-int;0;24;24;25/02/2021;202104;60;DOM
11201027;11201027-int;0;24;24;25/02/2021;202104;60;DOM
11201028;11201028-int;0;24;24;25/02/2021;202104;60;DOM
11201029;11201029-int;0;24;24;25/02/2021;202104;60;DOM
11201030;11201030-int;0;24;24;25/02/2021;202104;60;DOM
11201031;11201031-int;0;24;24;25/02/2021;202104;60;DOM
11201032;11201032-int;0;24;24;25/02/2021;202104;60;DOM
11203001;11203001-int;0;24;24;25/02/2021;202104;60;DOM
11203002;11203002-int;0;24;24;25/02/2021;202104;60;DOM
11203003;11203003-int;0;24;24;25/02/2021;202104;60;DOM
11203008;11203008-int;0;24;24;25/02/2021;202104;60;DOM
11203012;11203012-int;0;24;24;25/02/2021;202104;60;DOM
11203015;11203015-int;0;24;24;25/02/2021;202104;60;DOM
11204001;11204001-int;0;88;88;25/02/2021;202104;60;DOM
11204005;11204005-int;0;24;24;25/02/2021;202104;60;DOM
11206004;11206004-int;0;24;24;25/02/2021;202104;60;DOM
11207002;11207002-int;0;24;24;25/02/2021;202104;60;DOM
11214003;11214003-int;0;24;24;25/02/2021;202104;60;DOM
11214008;11214008-int;0;24;24;25/02/2021;202104;60;DOM
11214011;11214011-int;0;88;88;25/02/2021;202104;60;DOM
11214023;11214023-int;0;24;24;25/02/2021;202104;60;DOM
11220002;11220002-int;0;24;24;25/02/2021;202104;60;DOM
11220003;11220003-int;0;24;24;25/02/2021;202104;60;DOM
11220004;11220004-int;0;24;24;25/02/2021;202104;60;DOM
11220005;11220005-int;0;24;24;25/02/2021;202104;60;DOM
11220007;11220007-int;0;24;24;25/02/2021;202104;60;DOM
11220008;11220008-int;0;24;24;25/02/2021;202104;60;DOM
11220011;11220011-int;0;24;24;25/02/2021;202104;60;DOM
11220012;11220012-int;0;24;24;25/02/2021;202104;60;DOM
11220014;11220014-int;0;24;24;25/02/2021;202104;60;DOM
11220015;11220015-int;0;24;24;25/02/2021;202104;60;DOM
11220018;11220018-int;0;24;24;25/02/2021;202104;60;DOM
11220019;11220019-int;0;24;24;25/02/2021;202104;60;DOM
11220020;11220020-int;0;24;24;25/02/2021;202104;60;DOM
11220022;11220022-int;0;24;24;25/02/2021;202104;60;DOM
11220030;11220030-int;0;24;24;25/02/2021;202104;60;DOM
11220034;11220034-int;0;24;24;25/02/2021;202104;60;DOM
11224002;11224002-int;0;24;24;25/02/2021;202104;60;DOM
11224004;11224004-int;0;24;24;25/02/2021;202104;60;DOM
11224006;11224006-int;0;24;24;25/02/2021;202104;60;DOM
11224009;11224009-int;0;24;24;25/02/2021;202104;60;DOM
11228001;11228001-int;0;24;24;25/02/2021;202104;60;DOM
11228002;11228002-int;0;24;24;25/02/2021;202104;60;DOM
11228003;11228003-int;0;24;24;25/02/2021;202104;60;DOM
11228004;11228004-int;0;24;24;25/02/2021;202104;60;DOM
11228005;11228005-int;0;24;24;25/02/2021;202104;60;DOM
11228006;11228006-int;0;24;24;25/02/2021;202104;60;DOM
11228007;11228007-int;0;24;24;25/02/2021;202104;60;DOM
11228008;11228008-int;0;24;24;25/02/2021;202104;60;DOM
11228009;11228009-int;0;24;24;25/02/2021;202104;60;DOM
11228010;11228010-int;0;24;24;25/02/2021;202104;60;DOM
11228011;11228011-int;0;24;24;25/02/2021;202104;60;DOM
11229001;11229001-int;0;24;24;25/02/2021;202104;60;DOM
11229002;11229002-int;0;24;24;25/02/2021;202104;60;DOM
11229003;11229003-int;0;24;24;25/02/2021;202104;60;DOM
11229004;11229004-int;0;24;24;25/02/2021;202104;60;DOM
11229005;11229005-int;0;24;24;25/02/2021;202104;60;DOM
11229006;11229006-int;0;24;24;25/02/2021;202104;60;DOM
11229007;11229007-int;0;24;24;25/02/2021;202104;60;DOM
11229008;11229008-int;0;24;24;25/02/2021;202104;60;DOM
11229009;11229009-int;0;24;24;25/02/2021;202104;60;DOM
11229010;11229010-int;0;24;24;25/02/2021;202104;60;DOM
11229011;11229011-int;0;24;24;25/02/2021;202104;60;DOM
11229012;11229012-int;0;24;24;25/02/2021;202104;60;DOM
11229013;11229013-int;0;24;24;25/02/2021;202104;60;DOM
11229014;11229014-int;0;24;24;25/02/2021;202104;60;DOM
11229015;11229015-int;0;24;24;25/02/2021;202104;60;DOM
11229016;11229016-int;0;24;24;25/02/2021;202104;60;DOM
11229017;11229017-int;0;24;24;25/02/2021;202104;60;DOM
11229018;11229018-int;0;24;24;25/02/2021;202104;60;DOM
11229019;11229019-int;0;24;24;25/02/2021;202104;60;DOM
11229020;11229020-int;0;24;24;25/02/2021;202104;60;DOM
11301001;11301001-int;0;24;24;25/02/2021;202104;60;DOM
11303005;11303005-int;0;24;24;25/02/2021;202104;60;DOM
11304001;11304001-int;0;24;24;25/02/2021;202104;60;DOM
11304003;11304003-int;0;24;24;25/02/2021;202104;60;DOM
11501001;11501001-int;0;24;24;25/02/2021;202104;60;DOM
11501002;11501002-int;0;24;24;25/02/2021;202104;60;DOM
11501005;11501005-int;0;24;24;25/02/2021;202104;60;DOM
11501006;11501006-int;0;24;24;25/02/2021;202104;60;DOM
11501007;11501007-int;0;24;24;25/02/2021;202104;60;DOM
11501008;11501008-int;0;24;24;25/02/2021;202104;60;DOM
11501009;11501009-int;0;24;24;25/02/2021;202104;60;DOM
11502001;11502001-int;0;88;88;25/02/2021;202104;60;DOM
11502002;11502002-int;0;88;88;25/02/2021;202104;60;DOM
11502003;11502003-int;0;88;88;25/02/2021;202104;60;DOM
11502004;11502004-int;0;88;88;25/02/2021;202104;60;DOM
11503001;11503001-int;0;24;24;25/02/2021;202104;60;DOM
11503002;11503002-int;0;24;24;25/02/2021;202104;60;DOM
11503004;11503004-int;0;24;24;25/02/2021;202104;60;DOM
11503005;11503005-int;0;24;24;25/02/2021;202104;60;DOM
11503006;11503006-int;0;88;88;25/02/2021;202104;60;DOM
11503007;11503007-int;0;24;24;25/02/2021;202104;60;DOM
11503009;11503009-int;0;24;24;25/02/2021;202104;60;DOM
11503010;11503010-int;0;24;24;25/02/2021;202104;60;DOM
11503012;11503012-int;0;24;24;25/02/2021;202104;60;DOM
11503013;11503013-int;0;24;24;25/02/2021;202104;60;DOM
11503014;11503014-int;0;24;24;25/02/2021;202104;60;DOM
11503015;11503015-int;0;24;24;25/02/2021;202104;60;DOM
11503016;11503016-int;0;24;24;25/02/2021;202104;60;DOM
11503017;11503017-int;0;24;24;25/02/2021;202104;60;DOM
11503018;11503018-int;0;24;24;25/02/2021;202104;60;DOM
11503019;11503019-int;0;24;24;25/02/2021;202104;60;DOM
11503020;11503020-int;0;24;24;25/02/2021;202104;60;DOM
11503021;11503021-int;0;24;24;25/02/2021;202104;60;DOM
11503022;11503022-int;0;24;24;25/02/2021;202104;60;DOM
11503023;11503023-int;0;24;24;25/02/2021;202104;60;DOM
11503024;11503024-int;0;24;24;25/02/2021;202104;60;DOM
11503025;11503025-int;0;24;24;25/02/2021;202104;60;DOM
11503027;11503027-int;0;24;24;25/02/2021;202104;60;DOM
11503028;11503028-int;0;24;24;25/02/2021;202104;60;DOM
11503029;11503029-int;0;24;24;25/02/2021;202104;60;DOM
11503030;11503030-int;0;24;24;25/02/2021;202104;60;DOM
11503031;11503031-int;0;24;24;25/02/2021;202104;60;DOM
11503032;11503032-int;0;24;24;25/02/2021;202104;60;DOM
11503033;11503033-int;0;24;24;25/02/2021;202104;60;DOM
11503034;11503034-int;0;24;24;25/02/2021;202104;60;DOM
11503035;11503035-int;0;24;24;25/02/2021;202104;60;DOM
11503036;11503036-int;0;24;24;25/02/2021;202104;60;DOM
11503037;11503037-int;0;24;24;25/02/2021;202104;60;DOM
11503039;11503039-int;0;24;24;25/02/2021;202104;60;DOM
11503040;11503040-int;0;24;24;25/02/2021;202104;60;DOM
11503042;11503042-int;0;88;88;25/02/2021;202104;60;DOM
11503043;11503043-int;0;88;88;25/02/2021;202104;60;DOM
11503046;11503046-int;0;88;88;25/02/2021;202104;60;DOM
11503047;11503047-int;0;88;88;25/02/2021;202104;60;DOM
11503048;11503048-int;0;88;88;25/02/2021;202104;60;DOM
11503049;11503049-int;0;88;88;25/02/2021;202104;60;DOM
11503050;11503050-int;0;88;88;25/02/2021;202104;60;DOM
11503051;11503051-int;0;88;88;25/02/2021;202104;60;DOM
11503052;11503052-int;0;88;88;25/02/2021;202104;60;DOM
11503055;11503055-int;0;88;88;25/02/2021;202104;60;DOM
11503056;11503056-int;0;88;88;25/02/2021;202104;60;DOM
22301021;22301021-int;0;24;24;25/02/2021;202104;60;DOM
22301024;22301024-int;0;24;24;25/02/2021;202104;60;DOM
22301027;22301027-int;0;24;24;25/02/2021;202104;60;DOM
22301029;22301029-int;0;24;24;25/02/2021;202104;60;DOM
22301033;22301033-int;0;24;24;25/02/2021;202104;60;DOM
22301036;22301036-int;0;24;24;25/02/2021;202104;60;DOM
22301037;22301037-int;0;24;24;25/02/2021;202104;60;DOM
22301038;22301038-int;0;24;24;25/02/2021;202104;60;DOM
22301042;22301042-int;0;24;24;25/02/2021;202104;60;DOM
22301049;22301049-int;0;24;24;25/02/2021;202104;60;DOM
22301052;22301052-int;0;24;24;25/02/2021;202104;60;DOM
22301053;22301053-int;0;24;24;25/02/2021;202104;60;DOM
22301054;22301054-int;0;24;24;25/02/2021;202104;60;DOM
22301055;22301055-int;0;24;24;25/02/2021;202104;60;DOM
22301064;22301064-int;0;24;24;25/02/2021;202104;60;DOM
22301066;22301066-int;0;24;24;25/02/2021;202104;60;DOM
22301070;22301070-int;0;88;88;25/02/2021;202104;60;DOM
22301071;22301071-int;0;24;24;25/02/2021;202104;60;DOM
22301085;22301085-int;0;24;24;25/02/2021;202104;60;DOM
22301091;22301091-int;0;44;44;25/02/2021;202104;60;DOM
22301101;22301101-int;0;24;24;25/02/2021;202104;60;DOM
22301103;22301103-int;0;24;24;25/02/2021;202104;60;DOM
22301104;22301104-int;0;24;24;25/02/2021;202104;60;DOM
22301105;22301105-int;0;24;24;25/02/2021;202104;60;DOM
22301107;22301107-int;0;24;24;25/02/2021;202104;60;DOM
22301112;22301112-int;0;24;24;25/02/2021;202104;60;DOM
22301114;22301114-int;0;24;24;25/02/2021;202104;60;DOM
22301122;22301122-int;0;24;24;25/02/2021;202104;60;DOM
22301126;22301126-int;0;24;24;25/02/2021;202104;60;DOM
22301133;22301133-int;0;24;24;25/02/2021;202104;60;DOM
22301135;22301135-int;0;24;24;25/02/2021;202104;60;DOM
22301136;22301136-int;0;24;24;25/02/2021;202104;60;DOM
22301137;22301137-int;0;24;24;25/02/2021;202104;60;DOM
22301138;22301138-int;0;24;24;25/02/2021;202104;60;DOM
22301140;22301140-int;0;24;24;25/02/2021;202104;60;DOM
22301145;22301145-int;0;24;24;25/02/2021;202104;60;DOM
22301148;22301148-int;0;24;24;25/02/2021;202104;60;DOM
22301149;22301149-int;0;24;24;25/02/2021;202104;60;DOM
22301151;22301151-int;0;24;24;25/02/2021;202104;60;DOM
22301152;22301152-int;0;24;24;25/02/2021;202104;60;DOM
22301153;22301153-int;0;24;24;25/02/2021;202104;60;DOM
22301154;22301154-int;0;24;24;25/02/2021;202104;60;DOM
22301156;22301156-int;0;24;24;25/02/2021;202104;60;DOM
22301158;22301158-int;0;24;24;25/02/2021;202104;60;DOM
22301159;22301159-int;0;24;24;25/02/2021;202104;60;DOM
22301164;22301164-int;0;24;24;25/02/2021;202104;60;DOM
22301167;22301167-int;0;24;24;25/02/2021;202104;60;DOM
22301172;22301172-int;0;24;24;25/02/2021;202104;60;DOM
22301173;22301173-int;0;24;24;25/02/2021;202104;60;DOM
22301174;22301174-int;0;24;24;25/02/2021;202104;60;DOM
22302002;22302002-int;0;88;88;25/02/2021;202104;60;DOM
22302004;22302004-int;0;24;24;25/02/2021;202104;60;DOM
22302005;22302005-int;0;24;24;25/02/2021;202104;60;DOM
22302007;22302007-int;0;24;24;25/02/2021;202104;60;DOM
22302009;22302009-int;0;24;24;25/02/2021;202104;60;DOM
22302010;22302010-int;0;24;24;25/02/2021;202104;60;DOM
22302012;22302012-int;0;88;88;25/02/2021;202104;60;DOM
22302013;22302013-int;0;24;24;25/02/2021;202104;60;DOM
22302014;22302014-int;0;24;24;25/02/2021;202104;60;DOM
22302018;22302018-int;0;24;24;25/02/2021;202104;60;DOM
22302020;22302020-int;0;24;24;25/02/2021;202104;60;DOM
22303001;22303001-int;0;24;24;25/02/2021;202104;60;DOM
22303003;22303003-int;0;44;44;25/02/2021;202104;60;DOM
22303004;22303004-int;0;24;24;25/02/2021;202104;60;DOM
22303005;22303005-int;0;24;24;25/02/2021;202104;60;DOM
22303006;22303006-int;0;24;24;25/02/2021;202104;60;DOM
22303007;22303007-int;0;24;24;25/02/2021;202104;60;DOM
22303008;22303008-int;0;24;24;25/02/2021;202104;60;DOM
22303009;22303009-int;0;24;24;25/02/2021;202104;60;DOM
22303010;22303010-int;0;44;44;25/02/2021;202104;60;DOM
22303012;22303012-int;0;24;24;25/02/2021;202104;60;DOM
22303013;22303013-int;0;24;24;25/02/2021;202104;60;DOM
22303014;22303014-int;0;24;24;25/02/2021;202104;60;DOM
22303015;22303015-int;0;24;24;25/02/2021;202104;60;DOM
22303016;22303016-int;0;24;24;25/02/2021;202104;60;DOM
22303017;22303017-int;0;44;44;25/02/2021;202104;60;DOM
22303018;22303018-int;0;24;24;25/02/2021;202104;60;DOM
22303019;22303019-int;0;24;24;25/02/2021;202104;60;DOM
22303021;22303021-int;0;24;24;25/02/2021;202104;60;DOM
22303022;22303022-int;0;24;24;25/02/2021;202104;60;DOM
22303023;22303023-int;0;24;24;25/02/2021;202104;60;DOM
22303028;22303028-int;0;24;24;25/02/2021;202104;60;DOM
22303031;22303031-int;0;24;24;25/02/2021;202104;60;DOM
22304001;22304001-int;0;88;88;25/02/2021;202104;60;DOM
22304004;22304004-int;0;24;24;25/02/2021;202104;60;DOM
22304005;22304005-int;0;88;88;25/02/2021;202104;60;DOM
22304009;22304009-int;0;24;24;25/02/2021;202104;60;DOM
22304016;22304016-int;0;24;24;25/02/2021;202104;60;DOM
22501002;22501002-int;0;24;24;25/02/2021;202104;60;DOM
22501005;22501005-int;0;24;24;25/02/2021;202104;60;DOM
22501011;22501011-int;0;24;24;25/02/2021;202104;60;DOM
22501012;22501012-int;0;24;24;25/02/2021;202104;60;DOM
22501015;22501015-int;0;24;24;25/02/2021;202104;60;DOM
22501016;22501016-int;0;24;24;25/02/2021;202104;60;DOM
22501017;22501017-int;0;24;24;25/02/2021;202104;60;DOM
22501018;22501018-int;0;24;24;25/02/2021;202104;60;DOM
22501019;22501019-int;0;44;44;25/02/2021;202104;60;DOM
22501023;22501023-int;0;24;24;25/02/2021;202104;60;DOM
22501024;22501024-int;0;24;24;25/02/2021;202104;60;DOM
22501025;22501025-int;0;24;24;25/02/2021;202104;60;DOM
22501027;22501027-int;0;24;24;25/02/2021;202104;60;DOM
22501028;22501028-int;0;24;24;25/02/2021;202104;60;DOM
22501029;22501029-int;0;24;24;25/02/2021;202104;60;DOM
22501030;22501030-int;0;24;24;25/02/2021;202104;60;DOM
22501031;22501031-int;0;24;24;25/02/2021;202104;60;DOM
22501036;22501036-int;0;24;24;25/02/2021;202104;60;DOM
22501037;22501037-int;0;24;24;25/02/2021;202104;60;DOM
22501038;22501038-int;0;24;24;25/02/2021;202104;60;DOM
22501047;22501047-int;0;24;24;25/02/2021;202104;60;DOM
22501052;22501052-int;0;24;24;25/02/2021;202104;60;DOM
22501053;22501053-int;0;24;24;25/02/2021;202104;60;DOM
22501054;22501054-int;0;24;24;25/02/2021;202104;60;DOM
22501056;22501056-int;0;24;24;25/02/2021;202104;60;DOM
22501057;22501057-int;0;24;24;25/02/2021;202104;60;DOM
22501058;22501058-int;0;24;24;25/02/2021;202104;60;DOM
22501059;22501059-int;0;24;24;25/02/2021;202104;60;DOM
22501060;22501060-int;0;24;24;25/02/2021;202104;60;DOM
22501062;22501062-int;0;24;24;25/02/2021;202104;60;DOM
22501066;22501066-int;0;24;24;25/02/2021;202104;60;DOM
22501073;22501073-int;0;24;24;25/02/2021;202104;60;DOM
22501077;22501077-int;0;24;24;25/02/2021;202104;60;DOM
22501080;22501080-int;0;24;24;25/02/2021;202104;60;DOM
22501081;22501081-int;0;24;24;25/02/2021;202104;60;DOM
22501082;22501082-int;0;24;24;25/02/2021;202104;60;DOM
22501083;22501083-int;0;24;24;25/02/2021;202104;60;DOM
22501084;22501084-int;0;24;24;25/02/2021;202104;60;DOM
22501085;22501085-int;0;24;24;25/02/2021;202104;60;DOM
22501086;22501086-int;0;24;24;25/02/2021;202104;60;DOM
22501087;22501087-int;0;44;44;25/02/2021;202104;60;DOM
22501089;22501089-int;0;24;24;25/02/2021;202104;60;DOM
22501091;22501091-int;0;24;24;25/02/2021;202104;60;DOM
22501092;22501092-int;0;24;24;25/02/2021;202104;60;DOM
22501093;22501093-int;0;24;24;25/02/2021;202104;60;DOM
22501094;22501094-int;0;24;24;25/02/2021;202104;60;DOM
22501096;22501096-int;0;24;24;25/02/2021;202104;60;DOM
22501099;22501099-int;0;24;24;25/02/2021;202104;60;DOM
22528004;22528004-int;0;24;24;25/02/2021;202104;60;DOM
22528008;22528008-int;0;24;24;25/02/2021;202104;60;DOM
22528010;22528010-int;0;24;24;25/02/2021;202104;60;DOM
22528011;22528011-int;0;24;24;25/02/2021;202104;60;DOM
22528014;22528014-int;0;24;24;25/02/2021;202104;60;DOM
22528015;22528015-int;0;24;24;25/02/2021;202104;60;DOM
22528016;22528016-int;0;24;24;25/02/2021;202104;60;DOM
22528017;22528017-int;0;24;24;25/02/2021;202104;60;DOM
22528018;22528018-int;0;24;24;25/02/2021;202104;60;DOM
22528019;22528019-int;0;24;24;25/02/2021;202104;60;DOM
22528020;22528020-int;0;24;24;25/02/2021;202104;60;DOM
22528021;22528021-int;0;24;24;25/02/2021;202104;60;DOM
22528023;22528023-int;0;24;24;25/02/2021;202104;60;DOM
22528028;22528028-int;0;24;24;25/02/2021;202104;60;DOM
22528029;22528029-int;0;24;24;25/02/2021;202104;60;DOM
22528030;22528030-int;0;24;24;25/02/2021;202104;60;DOM
22528031;22528031-int;0;24;24;25/02/2021;202104;60;DOM
22528032;22528032-int;0;24;24;25/02/2021;202104;60;DOM
22528033;22528033-int;0;88;88;25/02/2021;202104;60;DOM
22528035;22528035-int;0;24;24;25/02/2021;202104;60;DOM
22528041;22528041-int;0;24;24;25/02/2021;202104;60;DOM
22701001;22701001-int;0;24;24;25/02/2021;202104;60;DOM
22701002;22701002-int;0;24;24;25/02/2021;202104;60;DOM
22701003;22701003-int;0;24;24;25/02/2021;202104;60;DOM
22701004;22701004-int;0;24;24;25/02/2021;202104;60;DOM
22701005;22701005-int;0;24;24;25/02/2021;202104;60;DOM
22701006;22701006-int;0;24;24;25/02/2021;202104;60;DOM
22701007;22701007-int;0;24;24;25/02/2021;202104;60;DOM
22701015;22701015-int;0;24;24;25/02/2021;202104;60;DOM
22701020;22701020-int;0;24;24;25/02/2021;202104;60;DOM
22702002;22702002-int;0;88;88;25/02/2021;202104;60;DOM
22702009;22702009-int;0;24;24;25/02/2021;202104;60;DOM
22702010;22702010-int;0;24;24;25/02/2021;202104;60;DOM
22702011;22702011-int;0;24;24;25/02/2021;202104;60;DOM
22702012;22702012-int;0;24;24;25/02/2021;202104;60;DOM
22702013;22702013-int;0;44;44;25/02/2021;202104;60;DOM
22702019;22702019-int;0;24;24;25/02/2021;202104;60;DOM
22702020;22702020-int;0;24;24;25/02/2021;202104;60;DOM
22702022;22702022-int;0;24;24;25/02/2021;202104;60;DOM
22702023;22702023-int;0;24;24;25/02/2021;202104;60;DOM
22703002;22703002-int;0;24;24;25/02/2021;202104;60;DOM
22703004;22703004-int;0;24;24;25/02/2021;202104;60;DOM
22705002;22705002-int;0;24;24;25/02/2021;202104;60;DOM
22705003;22705003-int;0;24;24;25/02/2021;202104;60;DOM
22705005;22705005-int;0;44;44;25/02/2021;202104;60;DOM
22705006;22705006-int;0;88;88;25/02/2021;202104;60;DOM
22705014;22705014-int;0;24;24;25/02/2021;202104;60;DOM
22705015;22705015-int;0;24;24;25/02/2021;202104;60;DOM
22705022;22705022-int;0;24;24;25/02/2021;202104;60;DOM
22705029;22705029-int;0;24;24;25/02/2021;202104;60;DOM
23401005;23401005-int;0;24;24;25/02/2021;202104;60;DOM
23401006;23401006-int;0;24;24;25/02/2021;202104;60;DOM
23401012;37219579671-1;0;24;24;25/02/2021;202104;60;DOM
23401014;23401014-int;0;24;24;25/02/2021;202104;60;DOM
23401016;23401016-int;0;88;88;25/02/2021;202104;60;DOM
23401018;23401018-int;0;24;24;25/02/2021;202104;60;DOM
23401022;23401022-int;0;24;24;25/02/2021;202104;60;DOM
23401031;23401031-int;0;24;24;25/02/2021;202104;60;DOM
23401036;23401036-int;0;24;24;25/02/2021;202104;60;DOM
23401040;23401040-int;0;24;24;25/02/2021;202104;60;DOM
23401041;23401041-int;0;24;24;25/02/2021;202104;60;DOM
23401042;23401042-int;0;24;24;25/02/2021;202104;60;DOM
23401043;23401043-int;0;24;24;25/02/2021;202104;60;DOM
23401044;23401044-int;0;24;24;25/02/2021;202104;60;DOM
23401046;23401046-int;0;24;24;25/02/2021;202104;60;DOM
23401049;23401049-int;0;24;24;25/02/2021;202104;60;DOM
23401052;23401052-int;0;24;24;25/02/2021;202104;60;DOM
23401055;23401055-int;0;24;24;25/02/2021;202104;60;DOM
23401057;23401057-int;0;24;24;25/02/2021;202104;60;DOM
23401058;23401058-int;0;24;24;25/02/2021;202104;60;DOM
23401060;23401060-int;0;24;24;25/02/2021;202104;60;DOM
23401061;23401061-int;0;24;24;25/02/2021;202104;60;DOM
23401062;23401062-int;0;24;24;25/02/2021;202104;60;DOM
23401066;23401066-int;0;24;24;25/02/2021;202104;60;DOM
23401071;23401071-int;0;24;24;25/02/2021;202104;60;DOM
23401074;23401074-int;0;24;24;25/02/2021;202104;60;DOM
23401075;23401075-int;0;24;24;25/02/2021;202104;60;DOM
23401082;23401082-int;0;88;88;25/02/2021;202104;60;DOM
23401083;23401083-int;0;24;24;25/02/2021;202104;60;DOM
23401085;23401085-int;0;24;24;25/02/2021;202104;60;DOM
23401086;23401086-int;0;24;24;25/02/2021;202104;60;DOM
23501001;23501001-int;0;24;24;25/02/2021;202104;60;DOM
23501004;23501004-int;0;88;88;25/02/2021;202104;60;DOM
23501008;23501008-int;0;44;44;25/02/2021;202104;60;DOM
23501016;23501016-int;0;44;44;25/02/2021;202104;60;DOM
23501020;23501020-int;0;24;24;25/02/2021;202104;60;DOM
23501021;23501021-int;0;24;24;25/02/2021;202104;60;DOM
23501022;23501022-int;0;24;24;25/02/2021;202104;60;DOM
23501023;23501023-int;0;24;24;25/02/2021;202104;60;DOM
23501026;23501026-int;0;44;44;25/02/2021;202104;60;DOM
23501029;23501029-int;0;24;24;25/02/2021;202104;60;DOM
23501030;23501030-int;0;24;24;25/02/2021;202104;60;DOM
23501031;23501031-int;0;24;24;25/02/2021;202104;60;DOM
23501034;23501034-int;0;88;88;25/02/2021;202104;60;DOM
23501040;23501040-int;0;24;24;25/02/2021;202104;60;DOM
23501043;23501043-int;0;24;24;25/02/2021;202104;60;DOM
23501045;23501045-int;0;24;24;25/02/2021;202104;60;DOM
23501046;23501046-int;0;24;24;25/02/2021;202104;60;DOM
23501047;23501047-int;0;24;24;25/02/2021;202104;60;DOM
23501048;23501048-int;0;24;24;25/02/2021;202104;60;DOM
23501049;23501049-int;0;24;24;25/02/2021;202104;60;DOM
23501052;23501052-int;0;44;44;25/02/2021;202104;60;DOM
23501053;23501053-int;0;88;88;25/02/2021;202104;60;DOM
23501058;23501058-int;0;24;24;25/02/2021;202104;60;DOM
23501059;23501059-int;0;24;24;25/02/2021;202104;60;DOM
23501060;23501060-int;0;24;24;25/02/2021;202104;60;DOM
23501061;23501061-int;0;24;24;25/02/2021;202104;60;DOM
23501063;23501063-int;0;24;24;25/02/2021;202104;60;DOM
23501064;23501064-int;0;24;24;25/02/2021;202104;60;DOM
23501067;23501067-int;0;24;24;25/02/2021;202104;60;DOM
23509001;23509001-int;0;24;24;25/02/2021;202104;60;DOM
23509002;23509002-int;0;88;88;25/02/2021;202104;60;DOM
23509005;23509005-int;0;24;24;25/02/2021;202104;60;DOM
23509008;23509008-int;0;24;24;25/02/2021;202104;60;DOM
23509010;23509010-int;0;24;24;25/02/2021;202104;60;DOM
23509011;23509011-int;0;24;24;25/02/2021;202104;60;DOM
23509013;23509013-int;0;24;24;25/02/2021;202104;60;DOM
23509015;23509015-int;0;24;24;25/02/2021;202104;60;DOM
23509016;23509016-int;0;24;24;25/02/2021;202104;60;DOM
23509017;23509017-int;0;24;24;25/02/2021;202104;60;DOM
23509018;23509018-int;0;24;24;25/02/2021;202104;60;DOM
23509024;23509024-int;0;88;88;25/02/2021;202104;60;DOM
23509027;23509027-int;0;88;88;25/02/2021;202104;60;DOM
23509028;23509028-int;0;88;88;25/02/2021;202104;60;DOM
23509032;23509032-int;0;24;24;25/02/2021;202104;60;DOM
23509036;23509036-int;0;24;24;25/02/2021;202104;60;DOM
23509038;23509038-int;0;24;24;25/02/2021;202104;60;DOM
23509039;23509039-int;0;24;24;25/02/2021;202104;60;DOM
23509041;23509041-int;0;24;24;25/02/2021;202104;60;DOM
23509042;23509042-int;0;24;24;25/02/2021;202104;60;DOM
23509043;23509043-int;0;24;24;25/02/2021;202104;60;DOM
23509044;23509044-int;0;24;24;25/02/2021;202104;60;DOM
23509045;23509045-int;0;88;88;25/02/2021;202104;60;DOM
23509047;23509047-int;0;24;24;25/02/2021;202104;60;DOM
23509049;23509049-int;0;24;24;25/02/2021;202104;60;DOM
23509050;23509050-int;0;24;24;25/02/2021;202104;60;DOM
24301001;24301001-int;0;24;24;25/02/2021;202104;60;DOM
24301002;24301002-int;0;24;24;25/02/2021;202104;60;DOM
24301004;24301004-int;0;24;24;25/02/2021;202104;60;DOM
24301010;24301010-int;0;24;24;25/02/2021;202104;60;DOM
24301012;24301012-int;0;24;24;25/02/2021;202104;60;DOM
24301015;24301015-int;0;24;24;25/02/2021;202104;60;DOM
24301016;24301016-int;0;24;24;25/02/2021;202104;60;DOM
24301018;24301018-int;0;24;24;25/02/2021;202104;60;DOM
24301019;24301019-int;0;24;24;25/02/2021;202104;60;DOM
24301021;24301021-int;0;24;24;25/02/2021;202104;60;DOM
24301022;24301022-int;0;24;24;25/02/2021;202104;60;DOM
24301023;24301023-int;0;24;24;25/02/2021;202104;60;DOM
24301025;24301025-int;0;24;24;25/02/2021;202104;60;DOM
24302002;24302002-int;0;44;44;25/02/2021;202104;60;DOM
24302006;24302006-int;0;24;24;25/02/2021;202104;60;DOM
24302007;24302007-int;0;88;88;25/02/2021;202104;60;DOM
24302010;24302010-int;0;24;24;25/02/2021;202104;60;DOM
24302011;24302011-int;0;24;24;25/02/2021;202104;60;DOM
24302012;24302012-int;0;88;88;25/02/2021;202104;60;DOM
24302015;24302015-int;0;24;24;25/02/2021;202104;60;DOM
24302016;24302016-int;0;24;24;25/02/2021;202104;60;DOM
24302021;24302021-int;0;24;24;25/02/2021;202104;60;DOM
24302022;24302022-int;0;88;88;25/02/2021;202104;60;DOM
24302025;24302025-int;0;24;24;25/02/2021;202104;60;DOM
24302028;24302028-int;0;24;24;25/02/2021;202104;60;DOM
24302030;24302030-int;0;24;24;25/02/2021;202104;60;DOM
24302031;24302031-int;0;24;24;25/02/2021;202104;60;DOM
24302032;24302032-int;0;24;24;25/02/2021;202104;60;DOM
24302034;24302034-int;0;24;24;25/02/2021;202104;60;DOM
24302035;24302035-int;0;88;88;25/02/2021;202104;60;DOM
24302036;24302036-int;0;88;88;25/02/2021;202104;60;DOM
24302040;24302040-int;0;24;24;25/02/2021;202104;60;DOM
24302043;24302043-int;0;24;24;25/02/2021;202104;60;DOM
24302044;24302044-int;0;24;24;25/02/2021;202104;60;DOM
24302047;24302047-int;0;24;24;25/02/2021;202104;60;DOM
24302048;24302048-int;0;24;24;25/02/2021;202104;60;DOM
24302049;24302049-int;0;24;24;25/02/2021;202104;60;DOM
24302050;24302050-int;0;24;24;25/02/2021;202104;60;DOM
24302051;24302051-int;0;24;24;25/02/2021;202104;60;DOM
24302053;24302053-int;0;24;24;25/02/2021;202104;60;DOM
24302054;24302054-int;0;24;24;25/02/2021;202104;60;DOM
24302055;24302055-int;0;24;24;25/02/2021;202104;60;DOM
24302056;24302056-int;0;24;24;25/02/2021;202104;60;DOM
24302058;24302058-int;0;24;24;25/02/2021;202104;60;DOM
24302059;24302059-int;0;24;24;25/02/2021;202104;60;DOM
24302060;24302060-int;0;24;24;25/02/2021;202104;60;DOM
24302061;24302061-int;0;24;24;25/02/2021;202104;60;DOM
24302062;24302062-int;0;24;24;25/02/2021;202104;60;DOM
24302064;24302064-int;0;24;24;25/02/2021;202104;60;DOM
24302067;24302067-int;0;24;24;25/02/2021;202104;60;DOM
24302069;24302069-int;0;24;24;25/02/2021;202104;60;DOM
24302070;24302070-int;0;24;24;25/02/2021;202104;60;DOM
24303003;24303003-int;0;88;88;25/02/2021;202104;60;DOM
24303005;24303005-int;0;24;24;25/02/2021;202104;60;DOM
24303006;24303006-int;0;24;24;25/02/2021;202104;60;DOM
24303007;24303007-int;0;24;24;25/02/2021;202104;60;DOM
24303008;24303008-int;0;24;24;25/02/2021;202104;60;DOM
24303010;24303010-int;0;24;24;25/02/2021;202104;60;DOM
24303019;24303019-int;0;24;24;25/02/2021;202104;60;DOM
24303023;24303023-int;0;24;24;25/02/2021;202104;60;DOM
24304001;24304001-int;0;24;24;25/02/2021;202104;60;DOM
24304002;24304002-int;0;24;24;25/02/2021;202104;60;DOM
24304005;24304005-int;0;44;44;25/02/2021;202104;60;DOM
24304008;24304008-int;0;24;24;25/02/2021;202104;60;DOM
24304010;24304010-int;0;24;24;25/02/2021;202104;60;DOM
24304011;24304011-int;0;24;24;25/02/2021;202104;60;DOM
24304014;24304014-int;0;44;44;25/02/2021;202104;60;DOM
24304015;24304015-int;0;44;44;25/02/2021;202104;60;DOM
24304016;24304016-int;0;24;24;25/02/2021;202104;60;DOM
24304018;24304018-int;0;24;24;25/02/2021;202104;60;DOM
24304020;24304020-int;0;24;24;25/02/2021;202104;60;DOM
24304023;24304023-int;0;24;24;25/02/2021;202104;60;DOM
24304024;24304024-int;0;24;24;25/02/2021;202104;60;DOM
24304026;24304026-int;0;24;24;25/02/2021;202104;60;DOM
24304027;24304027-int;0;24;24;25/02/2021;202104;60;DOM
24304030;24304030-int;0;24;24;25/02/2021;202104;60;DOM
24304049;24304049-int;0;24;24;25/02/2021;202104;60;DOM
24304053;24304053-int;0;24;24;25/02/2021;202104;60;DOM
24304054;24304054-int;0;24;24;25/02/2021;202104;60;DOM
24304055;24304055-int;0;24;24;25/02/2021;202104;60;DOM
24304060;24304060-int;0;24;24;25/02/2021;202104;60;DOM
24304061;24304061-int;0;24;24;25/02/2021;202104;60;DOM
24304062;24304062-int;0;24;24;25/02/2021;202104;60;DOM
24304063;24304063-int;0;24;24;25/02/2021;202104;60;DOM
24304067;24304067-int;0;24;24;25/02/2021;202104;60;DOM
24305001;24305001-int;0;24;24;25/02/2021;202104;60;DOM
24305008;24305008-int;0;24;24;25/02/2021;202104;60;DOM
24305009;24305009-int;0;24;24;25/02/2021;202104;60;DOM
24305011;24305011-int;0;24;24;25/02/2021;202104;60;DOM
24305016;24305016-int;0;24;24;25/02/2021;202104;60;DOM
24305018;24305018-int;0;24;24;25/02/2021;202104;60;DOM
24305020;24305020-int;0;24;24;25/02/2021;202104;60;DOM
24305022;24305022-int;0;24;24;25/02/2021;202104;60;DOM
24305027;24305027-int;0;24;24;25/02/2021;202104;60;DOM
24305028;24305028-int;0;24;24;25/02/2021;202104;60;DOM
24306003;24306003-int;0;24;24;25/02/2021;202104;60;DOM
24306005;24306005-int;0;24;24;25/02/2021;202104;60;DOM
24306007;24306007-int;0;24;24;25/02/2021;202104;60;DOM
24306009;24306009-int;0;24;24;25/02/2021;202104;60;DOM
24306010;24306010-int;0;88;88;25/02/2021;202104;60;DOM
24306015;24306015-int;0;44;44;25/02/2021;202104;60;DOM
24306016;24306016-int;0;24;24;25/02/2021;202104;60;DOM
24306021;24306021-int;0;24;24;25/02/2021;202104;60;DOM
24306022;24306022-int;0;24;24;25/02/2021;202104;60;DOM
24306025;24306025-int;0;24;24;25/02/2021;202104;60;DOM
24306026;24306026-int;0;44;44;25/02/2021;202104;60;DOM
24306028;24306028-int;0;88;88;25/02/2021;202104;60;DOM
24306033;24306033-int;0;88;88;25/02/2021;202104;60;DOM
24306037;24306037-int;0;24;24;25/02/2021;202104;60;DOM
24306038;24306038-int;0;24;24;25/02/2021;202104;60;DOM
24306040;24306040-int;0;24;24;25/02/2021;202104;60;DOM
24306052;24306052-int;0;24;24;25/02/2021;202104;60;DOM
24306053;24306053-int;0;24;24;25/02/2021;202104;60;DOM
24306054;24306054-int;0;24;24;25/02/2021;202104;60;DOM
24306058;24306058-int;0;24;24;25/02/2021;202104;60;DOM
24306060;24306060-int;0;24;24;25/02/2021;202104;60;DOM
24306062;24306062-int;0;24;24;25/02/2021;202104;60;DOM
24306066;24306066-int;0;24;24;25/02/2021;202104;60;DOM
24306067;24306067-int;0;24;24;25/02/2021;202104;60;DOM
24306068;24306068-int;0;24;24;25/02/2021;202104;60;DOM
24306069;24306069-int;0;24;24;25/02/2021;202104;60;DOM
24306071;24306071-int;0;24;24;25/02/2021;202104;60;DOM
24307003;24307003-int;0;24;24;25/02/2021;202104;60;DOM
24307004;24307004-int;0;44;44;25/02/2021;202104;60;DOM
24307005;24307005-int;0;24;24;25/02/2021;202104;60;DOM
24307006;24307006-int;0;24;24;25/02/2021;202104;60;DOM
24307007;24307007-int;0;24;24;25/02/2021;202104;60;DOM
24307009;24307009-int;0;24;24;25/02/2021;202104;60;DOM
24307010;24307010-int;0;24;24;25/02/2021;202104;60;DOM
24307012;24307012-int;0;24;24;25/02/2021;202104;60;DOM
24307015;24307015-int;0;24;24;25/02/2021;202104;60;DOM
24307017;24307017-int;0;24;24;25/02/2021;202104;60;DOM
24307020;24307020-int;0;24;24;25/02/2021;202104;60;DOM
24307022;24307022-int;0;24;24;25/02/2021;202104;60;DOM
24307023;24307023-int;0;24;24;25/02/2021;202104;60;DOM
24307024;24307024-int;0;24;24;25/02/2021;202104;60;DOM
24307025;24307025-int;0;24;24;25/02/2021;202104;60;DOM
24308003;24308003-int;0;24;24;25/02/2021;202104;60;DOM
24308007;24308007-int;0;24;24;25/02/2021;202104;60;DOM
24308008;24308008-int;0;24;24;25/02/2021;202104;60;DOM
24308009;24308009-int;0;24;24;25/02/2021;202104;60;DOM
24308013;24308013-int;0;24;24;25/02/2021;202104;60;DOM
24308014;24308014-int;0;44;44;25/02/2021;202104;60;DOM
24308017;24308017-int;0;88;88;25/02/2021;202104;60;DOM
24308018;24308018-int;0;24;24;25/02/2021;202104;60;DOM
24308019;24308019-int;0;88;88;25/02/2021;202104;60;DOM
24308032;24308032-int;0;24;24;25/02/2021;202104;60;DOM
24329034;24329034-int;0;24;24;25/02/2021;202104;60;DOM
24329035;24329035-int;0;24;24;25/02/2021;202104;60;DOM
24329036;24329036-int;0;24;24;25/02/2021;202104;60;DOM
24329040;37219563741-0;0;88;88;25/02/2021;202104;60;DOM
24329042;24329042-int;0;88;88;25/02/2021;202104;60;DOM
24329045;24329045-int;0;24;24;25/02/2021;202104;60;DOM
24329046;24329046-int;0;24;24;25/02/2021;202104;60;DOM
24329047;24329047-int;0;24;24;25/02/2021;202104;60;DOM
24329048;24329048-int;0;24;24;25/02/2021;202104;60;DOM
24329049;24329049-int;0;24;24;25/02/2021;202104;60;DOM
24329052;24329052-int;0;24;24;25/02/2021;202104;60;DOM
24329055;24329055-int;0;24;24;25/02/2021;202104;60;DOM
24329056;24329056-int;0;24;24;25/02/2021;202104;60;DOM
24329058;24329058-int;0;24;24;25/02/2021;202104;60;DOM
24329060;24329060-int;0;24;24;25/02/2021;202104;60;DOM
24329063;24329063-int;0;24;24;25/02/2021;202104;60;DOM
24329064;24329064-int;0;24;24;25/02/2021;202104;60;DOM
24329070;24329070-int;0;24;24;25/02/2021;202104;60;DOM
24329071;24329071-int;0;24;24;25/02/2021;202104;60;DOM
24329075;24329075-int;0;24;24;25/02/2021;202104;60;DOM
24329077;24329077-int;0;24;24;25/02/2021;202104;60;DOM
24329078;24329078-int;0;24;24;25/02/2021;202104;60;DOM
24329079;24329079-int;0;24;24;25/02/2021;202104;60;DOM
24329080;24329080-int;0;24;24;25/02/2021;202104;60;DOM
24329083;24329083-int;0;24;24;25/02/2021;202104;60;DOM
24329084;24329084-int;0;24;24;25/02/2021;202104;60;DOM
24329085;24329085-int;0;24;24;25/02/2021;202104;60;DOM
24329086;24329086-int;0;24;24;25/02/2021;202104;60;DOM
24329090;24329090-int;0;24;24;25/02/2021;202104;60;DOM
24329093;24329093-int;0;24;24;25/02/2021;202104;60;DOM
24329106;24329106-int;0;88;88;25/02/2021;202104;60;DOM
24343005;24343005-int;0;24;24;25/02/2021;202104;60;DOM
24343008;24343008-int;0;24;24;25/02/2021;202104;60;DOM
24343014;24343014-int;0;44;44;25/02/2021;202104;60;DOM
24343032;24343032-int;0;24;24;25/02/2021;202104;60;DOM
24343036;24343036-int;0;24;24;25/02/2021;202104;60;DOM
24343037;24343037-int;0;24;24;25/02/2021;202104;60;DOM
24343038;24343038-int;0;24;24;25/02/2021;202104;60;DOM
24343039;24343039-int;0;24;24;25/02/2021;202104;60;DOM
22523157;37219562842-7;0;173;173;25/02/2021;202104;60;DOM
22523160;37219568633-4;0;83;83;25/02/2021;202104;60;DOM
22523161;37219576636-7;0;42;42;25/02/2021;202104;60;DOM
22523162;37219576354-7;0;144;144;25/02/2021;202104;60;DOM
22523164;37219577055-9;0;3;3;25/02/2021;202104;60;DOM
22523167;37219576750-5;0;57;57;25/02/2021;202104;60;DOM
24302076;37219564889-6;0;10;10;25/02/2021;202104;60;DOM
24305073;37219573385-4;0;97;97;25/02/2021;202104;60;DOM
24305074;37219573203-9;0;31;31;25/02/2021;202104;60;DOM
24305076;37219573401-9;0;21;21;25/02/2021;202104;60;DOM
24305077;37219573112-2;0;104;104;25/02/2021;202104;60;DOM
24305078;37219569441-1;0;2;2;25/02/2021;202104;60;DOM
22301059;150303-0082;7684;7764;80;25/02/2021;202104;60;DOM
22308114;22308114-int;1082;1398;316;25/02/2021;202104;60;DOM
22501106;22501106-int;970;1023;53;25/02/2021;202104;60;DOM
22528036;22528036-int;2344;2443;99;25/02/2021;202104;60;DOM
22703011;22703011-int;1287;1352;65;25/02/2021;202104;60;DOM
23401080;170809-0109;3652;3813;161;25/02/2021;202104;60;DOM
23501011;23501011-int;1258;3804;2546;25/02/2021;202104;60;PROD
24302001;150303-0169;2176;2314;138;25/02/2021;202104;60;DOM
24302009;24302009-int;287;454;167;25/02/2021;202104;60;DOM
24304046;150303-0018;6783;6996;213;25/02/2021;202104;60;DOM
24306072;170809-0139;491;556;65;25/02/2021;202104;60;DOM
24308002;24308002-int;53;66;13;25/02/2021;202104;60;DOM
24341037;24341037-int;1019;1037;18;25/02/2021;202104;60;DOM
24342037;24342037-int;1060;1266;206;25/02/2021;202104;60;DOM
24342057;24342057-int;37;53;16;25/02/2021;202104;60;DOM
